#.##############################################################################################################################
#...##.....##........##.##  #  # # ##     ##    # ##    # # # # # # # # ## # # ## ##   ## # #  #        #        # #  #  ###   #
##.######.######.#.#.....## ## #    #####  #### # #####                  # #    #  ### ## # ## ######## ##### #### ## ##  #  # #
#.....###.#.###..######.##     ####  ## # ## #  #  ##   # # ###### #####   ####   ## #    #  # #  ##          ###  ## #  ## ####
## ##.#.......#####.##..#### #  # # ##     # ## # ##  # # # ##############      ###  ####   ##   ### ######## # # ###   ##  # ##
####..####.####.##...##..#.# ##      #####   #    ##### #####          # # ####  #  ###   ###  ### ### ###      #   ## ####    #
#.###.#.....#.#.#..#.###.#.##### # #  ##   # ####  ################### # ####   ## ## ## ##   ###  ##  # ###### # ####  ##  ####
#.......###.......##...#.#.##.#######    ### ##   ##   ## # ##   # #      # ###     # #   ## ## ##  ## # #  ##      #  ####    #
###.# ####  ### ###  #...#.##.#       ####   ####  ### #    #### # ######   ####### # ## ##      ## #    ## #  ###### ## ## ####
# ###### ## ############...#..#### #########    ##  #  ### ## #     # ##### # ##      #  ## # # ### ## #    ##   #    ##       #
#   ###   ###.........####.#.##..####    ######  ## ## ##       ###           ####### ##  ### ####  ##### #    #   ####### ## ##
## ## ## ############...##.#.###.## ### ##   ## ### ##    #######   # # ## ##   #   #    ###   ##  ## ##  #### ####### ##  #####
#        ## # #.......#......#.#.#         #    ##   #######      ### # ####### ### #### # ###  ## ##  ####     # ##    ## # ###
######## ## # #.##.######.##.#.#.##### # # ####  ## ### ## ############## #            # # # # ##   ##   ######    # # ##     ##
###         # ######.#.####......##..# ### ## # ##    # ##  ##      ## #    ## # #####   # # # #### #### # #    ###### ## # #  #
# ### ## # ##  ## #.....##..# ##..#.########     ### ## #  ######## ## ## #  ##### ##### # # #   #  # ## # ####  # ##   # ### ##
# # ###### ## ### ####.##..######.#..##   #  # #     ## ## ##        # ##### ## #            ### ## # ## # ## # ## ## #####    #
# #  # ##      #  #.....#####..#....#####   ###### #    ## #########     ###### ### # # ####   # #    ## #  # # #   #  # #### ##
# ## # ####### ## #####.#.#.##...##..##   # #      # ## #   # # ###### #  #     #   ###    ###   ### ##  ## # #   # # ## # ##  #
#      # #     #  ###.......#..#####.##################   # #   #  # #### ##### ### #   ###### #   #  ##      ## #### #  # ### #
###### # # # # ## # #.###.#.#####..#..## # ##       # ## ###### ## # ##    ###  #   ### ##   ##### # ##  ####    # ## # ## # # #
#####  # # ### ##   ###...#...#.##.#.##       ## ##      # ## # ##   #### ## ##   # # ###### #     # ###### ### ## ##   ## # # #
#   ## # ###    # #  ##.###.#...#....### ### ###########    #   ## ###        ## #### ## # # #####    # #           ###  #   # #
# # #  #  ##### #### #####..###.####.# ####### ### ### #### ###     ##### ###  # #         #    ### ### ####### ####### ## ### #
### ##   ## ##  ## # # # ######.##.#.#  #  ##               # ## ##  ## ##### ############ ### ## #  ## # #     #  ## # #   ## #
##   ###     ##      # # # ##...#..#.##   ####### # #######      ###    ### #   #  ### #   ### #  ##  # # ##### # ##  # # ###  #
#  ### ### # ####### # #    ###.##...#  ###  ## #####       ## # #   ## # # ### # ## # ### # # ##  # ##            # ## #   ## #
##   #     #         # #### #.#.#..#.##   ##     # #  # # ###  # # # #                 ##      ###    ############ # ## ### ## #
#### ######## ## # #   # #  #...####.### ##### #     ######   ########### # # ##### # ##### ##  ### #  # #      ##   ##  ## ## #
#      # #    #  # ### # ## ###...#...#  # ##  ########     #  ###        #####     #   #######     ##     # ##  ### ### ## ## #
#### ### #### ## #####       ####...#.##   ##### ## # ##### #### ### ########   ## ####    # ########  ## ######      #   # #  #
#     ## # #######     ##### # ######.####  # #  #    # ##  #     ####      ## ##### ##### # # ############ #    ####   ### # ##
#####  #   # #   #### ###       #........## # ##   ##      #### ### ### ### ####  #          # #    # # ##  ####### ### ##  #  #
## ###   #     #### ### #### ## ########.## # #  #  ######## ##  ##   ###     ### ##########   ## #     #  ## #          ##   ##
#    ### # ## ## #  ##   ######        #.##*#   ######## ##   # ### ####  ## ##     ##### #### ######## # ##  ######## #    ####
# ##     #### ## ##  ###   ##   #### # #...,# ### #         #   # # ##   ##     # #     ,,,##   ## # #       ### # # # ####    #
#### # # ##       ## #####  ##########   ##,###   ### # # ##### #    ###################,#,,## ##    #### ##  #  # # ### ## ####
## #####  ## ####      # # ######      ####,, ### ##  #####     # # ##     #   # #,,,,,,,##,,,,,#### ## ##### ## # #  #   #  # #
#   # ### ####    # ##      #   ## # # ## ##,##    #####  ##### # ######## ### ,,,,## ###### ##,,,,,,,# ## ##,,,,# ## # # ##   #
###    #### ### # ######### # ###  # ###    ,#### ## ##  ## ##,,,,## # #,,,,,##,##  ###### ###### # #,,,,,,,,,##,,,## ###  ## ##
######  ###     ##### #         ######### ##,,,## ##  ## #    ,##,#,,,,,,# #,,,,## ###        ##  # # # # ###### #,,# ##  ##   #
#  # ## # ## ####       # # # # #  ### #######,,,,#  ### #####,# ,,,## ###### # ## ##  ## # # ## #### #####  # ####,,,###    ###
##      # ####  #### ## ####### # ## # # #     ##,,,##   # #,,,# ##  #### # # ######## ## # #  ### ####  ###    #####,,,, ##   #
####### # # #  ## ########        ## # #   ## #####,,### ,,,,##########       #        #  # ##  #     ##   ## #  ## ####,#######
#       #   ##    # # ## # # # ##      # #  ### ####,# ##,## ## ## #  ############ ## ### ##### ## ##  ###  #### #  #   ,   ## #
#######   #    ##   # #  ##### ####### #######      ,# #,, # #     ## # ## #### ##  ### #####   ##  #### ## ## # ## ## #,# ### #
#       #### #  ###   ##       #        # ## ### # #,,,,,# ##### #  #      #     ## ##  ### ### ###  ##           # ####,####  #
# ## # ##    #####  #    ##### # # #### #        # # ## ##### ##### ###### ### #  #####           ##  ########### # # # , # ## #
# #  ###########   ### # ###   #####    ### #### # ###### # # # #           #####  ## ######### #  ##  # ### # #  # # ##,## ## #
# ####     #   ## ##   # #   #### #  ## #   #    ###            ## # ###### # # ## ##           ##  ## # #     ## # #  #,      #
# #    # #   #     ### ##### #      ###   # # ##  ###### ##### ######## #     #    ########## # ###      #####  # # ## #,### ###
#### # # ## #### ### # ## ## # # ## # ## ########## ##   #      # # ##    # # ####   ## ## ###### ### ## ## ###        #,  #   #
## #######  ##   #     #     ######## #  # # ## ##   ## ### # #        # ## #      #       # # ##  ####       ######## #,#### ##
#     # ########## # # # # ####    #    ##       ### #### ###### ## # ####### ### ### ## #      ##   ########      # #,,,  #####
##### #  # ## #### ### # # #    ##   ## ### ### ## #   #  ##   # ######### ################ # #  ### #    ##  ## #  ,,,# #  ####
###   ##            ######### ###  # #  #   #   ## ## ## ##  # ### # # # #  ##  ## #   ## ######     #### #  ##  ###,###### # ##
#   #  ######### # ## # ##  ####  ######### ###       ##  ####  ## #   # # #### #  ### #  ## # ##### ## # ####  ##  ,,# # ###  #
###### ##        # #     ## ## #### # ## ######### ##    ##  ## ##   #      ##    ##   ##  # # #            #########,      # ##
#       ######## # # ### ## #    #         ##  ######### ## ##  ########### ## ## #### ### # # ########## #  # # #   ,### #    #
# ## ##  ##   ## # ###      ## #   # ## ##  ##    ## ##  #  ###  # ## ## #   # #   ##      # #   # ##     ##       ##,  ##### ##
####### ##### ## # #   ####    # # # #   ##  ####     ## ## # ##         ## ##### ##  #### # ###    ### #  ## ######,,#    #####
## ##   ## #   ###### ### ##################      ###            # ### #     ## # ## ####      ## #   ##########    ,### #    ##
#  #  #  # ### ###    #   # ##   ###   ### ###### ##  ## #### ## ########### ##   ##### #### #  ### ########     ###,##  ## #  #
## # ### # #     ### ####    ## ## ### # # #### ##### ## #     ####   # #     ### # ##       ##  ## # # #  #### ##,,,###  # ## #
#  ####    ### # # ###  ### ##      #  #         ## # ## ## # ##    #     # #        # #########      # ## ######,,#  ## ####  #
##  # ### ###  ### ##  ##   ####### ## #### ## #  #   ########## #### # # # ## ## ## ####      ### ##         ,,,,###  #    # ##
###   # #   ##  ##  ##  ### # # ##      ######### ##### #  ### ###    ### #########   # ###### ##  ####### # #,## ##  ## ## ####
# # # # # # ### ### #  ####      ###### # ##      # ### ##  #   ############  ## ####             ## ####  # #,#   ## ####     #
#   #   ### # #  ##   ###   ## #        #  # # ## #     ### ### # # ##  ## ##  #   ## # # ## # # ##       ####,## ###   ########
### # #  #    # ##### # #####  ### # ##   ######    ### # #         ### #   ## # #    #####  ####### ### ## # ,,# #   #     #  #
########   ##    ##      # ### ########## # # #  # #### # #### ## #     ### #    # ## #     ### #    #      ###,# # # ## ##   ##
# ## # ## ### ##  ### ##    ## #  # # # # # #   ####      ######### # # ### ### ## ## # #####     # ## # # ##  ,# # # #  ## #  #
#         #    ## ### ## ## #####             #  ### ## #    ## ##  ###     #   ##  ###### ##### ####### #  ###,### ####  # ## #
# # # # ### # ##      ####  #  ## ## ## # ######## ######### #   ## ### # #   ###  ##  # #         ##    ## ## ,  # #    ## ## #
##### ##### ##### ## ## ### # ##   ##########  #    ## # ### # ###### ###### #########     # ## # ##### ##  ###,# # ### ##  ## #
#     ##    #     ## ##     # ######   # ## ## ## #    #        ## #      #####  ###   # ### #  ###      ## #  ,####### ## ##  #
# # ###  # ## #####   ## ##          #          #### #   ## ###  # ##### ## # ## # ############   ## ## ##  # #,,  ##   ## ### #
######## # ######   # #   ## # # ### ## #######  # ### #  ######   # # # ##      # ##   #   ##  ######   #######,#  ### ## # # #
#     ###### #    # #### ######### ###### ###### #     # ###  #### # # # ##### #    ### ###  # ##      #####    ,###### ##   # #
## ##  #####   # ##### #### #      ##  #           # # ###   ## #           ##### ####   ###   #### ## ##    # #,,### ##### ## #
###### # # #####  ##    # # ## ### ### #### ### ## ######  #      # # # ###  ###   # ###     #   ##  # #  # #####,      ##  ## #
# #        # ##  ##  ##     ## #        #   #   #  #  # ###### ## # # # #   ## ### # ### ### # #### ## ## ###   ,,## # ##  ##  #
# ########   #  ######  ### ###### ####   # # # #####    ################## #             ## #  ##   ######   ##,##### ###  # ##
# ###      # ## ##  #  ###   ##  ###    # # # ##### ### ## # #   # # # # #    # ## ## # # ##### ########    # ##,,##     # ##  #
# # ###### #  ##### #### ### ## ##   # #########     #         #         ## # # ## #  ###   # #     ## ## ###  ##,,#### ## ### #
#   # ####### ###   #            ### ### # #   #####   # # ### # # # ###    # # ## ## ##  ### # #####  #   ###  ##,##   ##   # #
### # #   # #   ###   ## ####### #   ### # ### #     # # ###   #######   ## #####  #  ### #     #   ##   # #   ## ,## #  ## ####
# #     #     #  ####  ###       ##### # # # # ##### # ###   # ############   ##  ### #   # ###   # #  # # # # ###, # ##  # # ##
#   # # ##### ##      ########## # ##    #     # ##  # #### #### # #        ###  ## ##########  # # ## # # # # # ,,## #  ##    #
# # ############# ## ##       #       ## #####      ## #     ##      # ## #  ### #             ## #  # # # ### ##,### ##  #### #
###### #          ## ##### ##   # # # #  # #### # ###  ## ###### # # # #####   #### # ### ## # #### #### ########,  # #  ####  #
## ##    # ###### ## # ###### ### # # ##        #  ### ##  ## ## # #####   # ###  ### #   ## #  ##    ##  ## ##  ,# ####    # ##
#     ## #  ##### #  #    # # #   ####### # ### ## # ##### #     #   ##### #   ##  #### # #  ####  # ##  ##   ###,#### # # ##  #
# ## ##  # ##   #########     # # ###########   #     ##   ####### ### #     #####   ## # ##    ## # ###  ###    ,,    # #  # ##
####### ####  #  # ## ###### ###### # ##   ### ## # #### # #       ##  #####   ##  #    ##### #  # #  ## ##   ####,######## #  #
#         ### ##             # # ##   ####     #### ## ########### ###       #### #### ####   # #### ##   # ##### ,,   ###### ##
## # # #### #### ### ## ## # #      #      # #  ##  #   ##  #      #   ### #  # ###    ##   # #  ##   # ######    #,##   ##    #
## # # #     #   ##   #### # # # ## ###### # # ########  ##   ## # # # ##  ##     ## # #### ### #### ##### #   ## #,## #  ## # #
#  #########   #  ## ##    #######  ##     ##### ###  ##  ## ####### # ## ### ###### # #     ## # #   ##     # #  #, # # ##  # #
# ####   # ## ########### ##    #####  # #### ## # # ##  ###### # ## ######   ### #  # ## # ##    ## ##  ##### ## #,## #  # ## #
###    #         ## #     ## ##    ## ####     # # #  ## ##           # ##### #     ## ## # ## # ##   ## #      ###,#### ## #  #
##### ## # # ## ##  ## # #########  ### #  ###   # # ##   #### # # # ## # #   # ###  ###  # #  # ## ###  ### ##  ##,   #  # ## #
#     #  # ###   ##  ###### #   ## ###  ####   #   # #### ###  # ### ##   ### ######  ## #########    ## ##   ## # ,##### # #  #
## ## ## # #   # #  ####  # ###      ## ##   #####   # #  # ####  ##  ###       # ## ##   ## ## ## ####  ### ### ##,,  #### ## #
#######  # ### ####  # ## # ##  # ##     #####     #   ##        ############ ###     # # #           ## #   #    ##,###  #  # #
# #     ## #      ##   #     ## ###### #       ##### #    # # #### ####         #### ## ###### # # ######### ## ####,    ## ## #
#   # #  #### # ######   ###    #   #  ##### # #     ### ######         # ## ## #     ###      # #    # #    #  ##  ,## ##  ####
# # # ## #    #### #   # #### ##### # ##     # # ######   ##    ## # ## ####  # # # ##### # ## # ## ### # # ## ##  #, #  ##    #
# # ####### # ## #   # ###    #        ### # # ###      # #### #####  ###    ## ###     ###### ####     ######  ####,#####  # ##
# # #       ###    # # #   # ######## ###### ###### ### # #    ## #  ###  ## ## #   # #  # # #  ##  # # ##     ###  ,,,,### #  #
# # ##### # #### # # ##### ### #      ##     ###    ##  # ####    ## ##  ##  ## ### # # ##     #### # #  #####   ## # #,,#### ##
# # ######### ## ###### #  ##  ##### ##### # #   # #### ###    # ##  ### ## ##  ##  # #  ### # ##   #### #     ###### ##,,######
# ###         ## #        ####  # #  ## #  ### # ###    #   # ## #####    # ### ### # ## #   # #  #    ### # #      # ###,,,,  #
# ##  # #####    ## ## # ##  ## # # ##  # ###  #   ####### ## ## #     # ## #   # # ###  ## ## # ### #   ##### ########   ##,###
#  #### # ### # #####  #####         ##   #   ### ##       #  ##### # ## ## # # #    ## ##  ## # ##  # # ## #       ##  #  #,  #
## #    #     #### ####### #### ## # ### ## # #    ##########   # # # #  #  # # ## #  ##### #### ### # # #    # # #  ## # ##,###
#  # ## ## # ##                 #  ### #  ####### ##          ###   # ## ## # # #  ##   ##    ## #   # ### ## # # # ##  # ##,, #
## ###  #  # ## ## # ## # # # # ## ##    ### ## ##### ### ###   ## ## #  #  # # ####  ###  # ##  # # ###   ## # # # ## ##  ##,##
########## # ## #  # #  # ##### ## ##### ##      ## # ### ##  #### #### ##### ### ###  ## ## #  ## #   ### #  ### # #  ## ## ,,#
#        ### #  ## # ## # #  #  #  #     #######      #    ##    #    ### ##  ##      #####  # ##  ###  ## ##   ##### #####  #,#
# # ####     # ##  # ####### # ### ### # #       ## # ### #### #### ###      ##  ## #  ##   ## ### ##  ### ## #### ## #   # ##,#
# # #    # # #  ## # #         #   ##  # ## # # ##  # #   ##     ##   ## ## #### #  # #### ##  #    ## ##  ##  ##       # # ##,#
##############################################################################################################################,#
