#.#############################################################################################################
#.#.#.#.#......................#...#...........#..#..#..##.#.#......##.#.#...#.#.#.......#.##.#.#.##..#.#..##.#
#.........### # ## # # #######.###.#####.###.#...##.##.###.#.#.####........###.#.#.##.####.#.......##.....##..#
## #### ###   #### ###########.....#.###########.......#.#........##.#.#.#.###......#...#....#.#.#..#.#####..##
#######  #### #    ##          # #..........#....##.####.#.#############.#...#.######.#...#.##.#.##......#..###
#       ##    # # ###### # ######## #######...#.##....#.............#..#######......#.#.#.#.####.####.##...##.#
##### # ## ## ### # # ####  ### # # #       #.#.##.##...##.####.##.##.###.##.#.######.###.#....#...##..#.#....#
#     ############# # # #  ## # # ####### # #.###...###.##....#..#..#.#......#....###.############..#.#########
#### #### # ### ##      ## ##      #      # #...##.####..#.#####.#.##...####...####.###.##.####..##.#.#.#.#.###
#  # #      # #  ## # #     ## ### #### # # #.#.##....##.#....####....########..##...##.#.......#####...#.#.#.#
## #### ### # ## #### #### ######   #   # # #.#.##.#.##..#.##....#.#.###.....##..##.##....##.#.###..#.#...#.#.#
## ###  ##       # #  #    #  #   #   #######.#..#.#####.#..##.#####.....#######..#....##.######.#.######.....#
#    ## #### ###     ### ####   # # ####......####...##..#.##...#.##.###..#.#..##...#######.#..#.#.#.#..#.#.###
## #    #..################### ## ###....#.##....#.#..#.##.####....#...##.....##..#...........##.......####...#
#  # # ###..#...##.##.#.#..#.#######..#.######.#####.##.##...##.#.###.##..#.####.###.##########..#####..####.##
## # ###.##.###.......#.#.##..#.###..##.##..... # #..#####.#.##.#####..#.##....###......#.#.#.##...######..#..#
#  # ###........##.##.#....##.......##..#####.#   ##...##..####...##..##.##.#.#######.#........#.#....#...##.##
## ###.########..###....##..#.####.####.#.....#####..#####....##.####.##..#.#.#..#..#.#####.##...#.##...#..#.##
#  #...#####....##...#.####...###....##.#.###.....##...##..#.##...##...#.##.#...##.############.####..######..#
######.......##.#..#####....#.#...##.#########.####..#.###.#..######.###.##.#.#.#...........#.#....##.##...#.##
#...#..#.###.#..#####.####.####.###..#,,,#,,,#,,,.##.#...###.##..##...##..#.#.#...#.#.#.#.###.##.####....######
#.#...####...#.####.........##...##.##,#,,,#,,,#,######.##......##..#..####.#.##.###########...####.##.####.#.#
#.##.##.#..#.###..#.#.#.#.###..#..###,,## ### ##,,#.#.######.#.####.##....###..###.#.#.#.##..####...#####.....#
#.#..#..##.###...########...##.##.#..,### #    ##,......##...#.#######.#.#####..............###...#.......###.#
#.##.##....#####...#.#....####..#####,##  ## # #.,##########.#..##.##..#....##.##.##.#.##.#.....#.#.#.###..##.#
#..#####.#.#.#.###.#.####..##..##...,, ##  ### ##,....#.#.##.##....#####.###########.#######.######.#.#########
#####....#.#...##.....#.#.####.##.##,# ### #   #.,###.....##.##.##.....#.........#.#....###.......###....##.###
##....##.#####.######......##..##.#.,### ### # ##,,##.#.#.##.##..##.#.###.#.#.##...##.#...##.####..###.#......#
#..#.######...........#.#.####.#..##,##   ## #  ##,,###.#..#.#..#####...#####.##.########..#...###...#.###.####
####.##...##.#.######.#.#..##..#.##.,,###    ######,,,#.#.#####...##..#.....#.#......#.##.##.#...###.#.########
###..#..#.##.#.#......#.#.##..#######,#   ## ####...#,###..##...####.###.#.####.#.##...##.####.#...###........#
#.#######.#..#####.##.###..##....##.#,# # #  #....#.#,,##.####.###.###.###....#.#..##.###....#####...##.#.##.##
#.#.#.......###.##.#..#...###.#.##*,,,# # ## #.#.##.##,.#.#..............#.#.##.#.###...####...#####..#.#..#.##
#.....#.#.#.##.....#.##.#.##..#.#  # #### #  ###.#..##,##.###.##.#.##.######..#.#...#.#....#.#.....#.####.##..#
################.#.#..###.##.#######   ## ##  ##.#.###,####....#.#..###...##.##.#.#.###.#.##.###.#####.#...##.#
##.#.#.####...#..#.#.###..#..##      # #   ##  ###.##.,,,.##.#########..####..#.#.#...#.#..#..##....#..########
#.......#.###.#.####...##.##..### ## ### # ## ##...###.#,###....#.#.#..###.##.#.#.##.##.#.###..##.###.##......#
#######.#.#.#....###.####.#..##   ## ##  #### #..#...###,..##.###.....##...######.#####.#..###..####...#.######
#.......#.#.##.#.#......####..###  # ###  ##  #####.##..,###......#.#....#.....##.....#.#.##.#####.#.#...###.##
#####.#........#.###.####....##   ####   #### ##....##.#,,.#.#.#.##.##.#.##.#.####.######.....##.....#.#......#
#...####.##.#.#####....##.#.### #  ### #   ##  ####.#####,####.#.##.##.#.##.###.#.....###.##.####.####.#.#.####
#.#......##.#.##....#.#######   # ## ### #  ## ##...#....,#.######...#####......###.#.#.######.#.....#.#.#....#
#####.##.##.#..####.#...##    # # ## ##  # ### #..#.##.##,,,,....#.#....##.###.##...#....#.###...#.#.###.##.#.#
#.....#..#..##.##...######## #### ##    ####   ##.#.#..#..##,#####.##.#.##...#.##.#.#.##.....#.###.#..##..#.#.#
#####.##.#.########.......## ##   ## # ##    # #..#.##.##.#.,,.#####..##################.#.#....##.#.###.##.#.#
#.#.########.###.#..#.###.##  ## ##### ##########.###...###.#,##...##............#.##....#.#.#.#####...###..#.#
#...###.#.##.......##.##..#  ##   ##      ##......#...#..##.#,,,,####.#.####.#####..###.####.####....#..#####.#
#.#...#.#....#.#.#..#.###.##  ###  #### ###..###.##.#.#.###.#.##,...##########.##..##.###.#..##.#######.....###
###.#.....#.##.#.#.##..##.### ### ##      #.##....#####.##..####,#####.#....##..##.##.....##.....#....##.######
#######.#.###..#.#..##.#### # #    ### # #######.##......##..##.,,,#.#...##..#.###....##.###.#.#...#######.##.#
#.##.##.#.#...##.#.##...###   ## # #####  ##.....######.##..##..##,....#######.##..####..##..#.#.#....#.##..#.#
#.......####.##..#.##.###   #  #####     #########.##....##..##.##,###...#.#.#....##########.###.##.#.#.##.##.#
#.#.#.#..##...##.#..#.#   # ##   #### ##  # #.......###.####.##.##,..#.###.....##.....#.#.####....###....#.#..#
###.###.####.##..##.##### ###  ### ###### # ##.#.##........#.#..##,#######.##.##..#.#.....#.############.....##
#...##.....#..##..####    ##  ##            ##.###..##.#.###.##.#.,,,,,,,,..#.###.###.#####..#.###.....#.######
##.####.##.##..##.## ### ##  ##### ###### #  ####..##..###...#..##.##.###,###..#####......##.#.#.#.###.#......#
#..##...######.#..##      ##  ## ###      # ##....####...###.##.##..####.,,,####...##.#.###..........###.#.#.##
##.##.#...#.##.##..## # #### ##   ### ## ##  ###.##....#######...##.##.##.#,,###.######.....##.###.#######.#.##
#..#..#.#...######.## #  ##  ####     #  ## #######.##.....##..####.....#.##,,,,....####.#.##....#......####..#
#.##.##.#.#......###### ####   ## # ### ### #..#....#..#.#..####....#.###.##.##,###....#.#####.#.#.##.#...#####
#.#..##.###.##.###      ## # #### # #     # ##.##.#.##.#.##...####.#####...#..#,..#.#.##...##..#####..#.#.....#
###.##...##.##..#### # ##    ##   # ### #####.....#.##.#..#.#.#..#.#.#.#.#.#.##,#######..#####.#...######.#####
#....##.##..##.##    # #  ## ### ## #    # ###.##.####.#.##.#.##.......#.###.#.,,#....##..#.#####.##.#..#.....#
###.##...##.#...## # # # ### # ####### #    ##.#..##...#..#.#####.#.#.##...#.#.#,..#.####....##.#......#####.##
##..#..#..#.##.##  ### # #     ## ##   # # ######..##.##.##....####.######.#.#.#,#####.###.#......#.##....##..#
#..###.##.######## ### # # ## ##   # # # # ##.....###.#####.####.....#.#####.###,,,##....#.#.###.##..##.#######
#.###..#.......# # #   # ######  #   # ### #..###.#.......#....###.#......##...#.#,...####.#..##.#####...#.##.#
#...##.##.##.###   ## ## #  #   ## # #   # ######.#.##.##.#.##.#...#.#.#.##..#.#.#,#.#######.##......###...#..#
#.#.##.##.#....### ## #####   # #  ### #####.##...#.##..#.#..#.##.######..##.#.###,###.....#..##.#.###...#...##
#.#.#..##.##.###    ###     # # # ##   ##.#.....#.#.###.#########.#.#.##.##..###..,,,,,###.##.##.#.#.##.##.####
#.#.##..####.#### # ##  ## ## ### ## # ##...##.##.#..##..#.#.##.......##..##...###.#.#,,,####.##.#...##..#....#
#.#.#..##.......# # ## #####   ##  ### ###.######.#.####......##.#.####..##..#.##..#.#.#,...#.##.#.#..#.##.#.##
#.#.##..###.#.#.# ###   ##   # #  ##    ##.##.....#...###.#.####.#....##..##.#####.#.###,##.###..#.#.##.####..#
#.####.##...#############  ###### #  # ###.######.#####...#..##..#.#.##..##...#.##.#.###,.##########..#...##.##
###.....###......##       ##      ## # ##..#.........##.#.##..##.#.#.###..###...##.#...#,###..###.###.#.###...#
##..##.##...#.########## ##  # ## ## #  ##.#.##.#.#.##..#..##..#.###..###..##.#.####.#.#,,,##.#.#.#.#########.#
#..###.###.##.#   # # ## ### ####  ####  #.#..###.#####.##..##.#..###..##.###.#..##..###.#,,,,,,,,,.......##..#
##.##..#...##.# #         #####   ##    #######......##.#..###.##...####....#.##.###..##.#.###.#.#,#####.####.#
#####.##.#..### # ### # #  ###  # #### ##.#.#####.##.#..#.##.###..#....##.#.###...###..#.#..##.#.#,....#.##...#
#.....#####.#   # #   # # ## ## #  #####...........#.##.#......##.##.#.##.#..##.###...##.#.#####.#,###.####.#.#
#####.#.#.#### ## # # # # #     ####..###.##.####.#####.#.#.####..#..####.####...###.###.#.....#.#,,,#####..#.#
#...........## ## ### ### ## # ######.....##.#......##..#.#....##.#.##.......##.##.....###.#######.#,,##.####.#
#####.##.##.## ## #    ## ## # ##...#.#####..#.#.##..##.#.#.#.##..#..###.#.#.#..##.##.####......##.##,,,,,,,#.#
##.#...#.##.######### #############.###.####.#.#.##.##..#.#.#####.######.#.#.##.##..###....#########..##.##,###
#....#.#.##.....##    ##.##.#.#.#....##......#.#.#...##.#.#....##...##...###.#...##..#####.........##..#..#,###
##.#####..#.#.#..######...........##....#.#.##.#.#.###..###.#####.######...#.##.####..####.#.#########.#.##,,.#
##...##..##.#.#.##......#.#.##.##.###.#####.##.###...##...#.....#.##.....###.##....##....#.#........####..##,##
#..#..##.##.#.#.#..#.##.#.#.##.#..#...##.....#.#...#.##.#.##.#.##..##.##...#.##.#.##..#.##.#.##.#.#....##..#,,#
#############################################################################################################,#
