#.#############################################################################################################
#.#.#.#.#......................#...#...........#..#..#..##.#.#......##.#.#...#.#.#.......#.##.#.#.##..#.#..##.#
#.........### # ## # # #######.###.#####.###.#...##.##.###.#.#.####........###.#.#.##.####.#.......##.....##..#
## #### ###   #### ###########.....#.###########.......#.#........##.#.#.#.###......#...#....#.#.#..#.#####..##
#######  #### #    ##          # #..........#....##.####.#.#############.#...#.######.#...#.##.#.##......#..###
#       ##    # # ###### # ######## #######...#.##....#.............#..#######......#.#.#.#.####.####.##...##.#
##### # ## ## ### # # ####  ### # # #       #.#.##.##...##.####.##.##.###.##.#.######.###.#....#...##..#.#....#
#     ############# # # #  ## # # ####### # #.###...###.##....#..#..#.#......#....###.############..#.#########
#### #### # ### ##      ## ##      #      # #...##.####..#.#####.#.##...####...####.###.##.####..##.#.#.#.#.###
#  # #      # #  ## # #     ## ### #### # # #.#.##....##.#....####....########..##...##.#.......#####...#.#.#.#
## #### ### # ## #### #### ######   #   # # #.#.##.#.##..#.##....#.#.###.....##..##.##....##.#.###..#.#...#.#.#
## ###  ##       # #  #    #  #   #   #######.#..#.#####.#..##.#####.....#######..#....##.######.#.######.....#
#    ## #### ###     ### ####   # # ####,,,,,,####...##..#.##...#.##.###..#.#..##...#######.#..#.#.#.#..#.#.###
## #    #..################### ## ###,,,,# ##,,  #.#..#.##.####....#...##.....##..#...........##.......####...#
#  # # ###..#...##.##.#.#..#.#######,,# ######,#####.##.##...##.#.###.##..#.####.###.##########..#####..####.##
## # ###.##.###.......#.#.##..#.###,,## ##   ,, # #..#####.#.##.#####..#.##....###......#.#.#.##...######..#..#
#  # ###........##.##.#....##,,,,,,,##  #####,#   ##...##..####...##..##.##.#.#######.#........#.#....#...##.##
## ###.########..###....##..#,#### #### #    ,#####..#####....##.####.##..#.#.#..#..#.#####.##...#.##...#..#.##
#  #...#####....##...#.####,,,###    ## # ###,,   ##...##..#.##...##...#.##.#...##.############.####..######..#
######.......##.#..#####..,,# #   ## #########,####..#.###.#..######.###.##.#.#.#...........#.#....##.##...#.##
#...#..#.###.#..#####.####,#### ###  #   #   #,,, ##.#...###.##..##...##..#.#.#...#.#.#.#.###.##.####....######
#.#...####...#.####......,, ##   ## ## #   #   #,######.##......##..#..####.#.##.###########...####.##.####.#.#
#.##.##.#..#.###  #.#.#.#,###  #  ###  ## ### ##,,# # ######.#.####.##....###..###.#.#.#.##..####...#####.....#
#.#..#..##.###   ########,..## ## #   ### #    ##,      ##...#.#######.#.#####..............###...#.......###.#
#.##.##....#####   # #  *,####  ##### ##  ## # # ,##########.#..##.##..#....##.##.##.#.##.#.....#.#.#.###..##.#
#..#####.#.# # ### # ####  ##  ##      ##  ### ##,    # # ##.##....#####.###########.#######.######.#.#########
#####....#.#   ##     # # #### ## ## # ### #   # ,###     ##.##.##.....#.........#.#....###.......###....##.###
##....##.##### ######      ##  ## #  ### ### # ##,,## # # ##.##..##.#.###.#.#.##...##.#...##.####..###.#......#
#..#.######           # # #### #  ## ##   ## #  ##,,### #  #.#..#####...#####.##.########..#...###...#.###.####
####.##   ## # ###### # #  ##  # ##   ###    ######,,,# # #####...##..#.....#.#......#.##.##.#...###.#.########
###..#  # ## # #      # # ##  ####### #   ## ####   #,###  ##...####.###.#.####.#.##...##.####.#...###........#
# ####### #  ##### ## ###  ##    ## # # # #  #    # #,,## ####.###.###.###....#.#..##.###....#####...##.#.##.##
# # #       ### ## #  #   ### # ##    # # ## # # ## ##, # #..............#.#.##.#.###...####...#####..#.#..#.##
#     # # # ##     # ## # ##  # #  # #### #  ### #  ##,## ###.##.#.##.######..#.#...#.#....#.#.....#.####.##..#
################ # #  ### ## #######   ## ##  ## # ###,####....#.#..###...##.##.#.#.###.#.##.###.#####.#...##.#
## # # ####   #  # # ###  #  ##      # #   ##  ### ## ,,, ##.#########..####..#.#.#...#.#..#..##....#..########
#       # ### # ####   ## ##  ### ## ### # ## ##   ### #,###....#.#.#..###.##.#.#.##.##.#.###..##.###.##......#
####### # # #    ### #### #  ##   ## ##  #### #  #   ###,  ##.###.....##...######.#####.#..###..####...#.######
#       # # ## # #      ####  ###  # ###  ##  ##### ##  ,###......#.#....#.....##.....#.#.##.#####.#.#...###.##
##### #        # ### ####    ##   ####   #### ##    ## #,, #.#.#.##.##.#.##.#.####.######.....##.....#.#......#
#   #### ## # #####    ## # ### #  ### #   ##  #### #####,####.#.##.##.#.##.###.#.....###.##.####.####.#.#.####
# #      ## # ##    # #######   # ## ### #  ## ##   #    ,# ######...#####......###.#.#.######.#.....#.#.#....#
##### ## ## #  #### #   ##    # # ## ##  # ### #  # ## ##,,,,    #.#....##.###.##...#....#.###...#.#.###.##.#.#
#     #  #  ## ##   ######## #### ##    ####   ## # #  #  ##,#####.##.#.##...#.##.#.#.##.....#.###.#..##..#.#.#
##### ## # ########       ## ##   ## # ##    # #  # ## ## # ,, #####..##################.#.#....##.#.###.##.#.#
# # ######## ### #  # ### ##  ## ##### ########## ###   ### #,##   ##............# ##....#.#.#.#####...###..#.#
#   ### # ##       ## ##  #  ##   ##      ##      #   #  ## #,,,,####.#.####.#####  ###.####.####....#..#####.#
# #   # #    # # #  # ### ##  ###  #### ###  ### ## # # ### # ##,   ########## ##  ## ### #..##.#######.....###
### #     # ## # # ##  ## ### ### ##      # ##    ##### ##  ####,##### #    ##  ## ##     ##.....#....##.######
####### # ###  # #  ## #### # #    ### # ####### ##      ##  ## ,,,# #   ##  # ###    ## ###.#.#...#######.##.#
# ## ## # #   ## # ##   ###   ## # #####  ##     ###### ##  ##  ##,    ####### ##  ####  ##..#.#.#....#.##..#.#
#       #### ##  # ## ###   #  #####     ######### ##    ##  ## ##,###   # # #    ##########.###.##.#.#.##.##.#
# # # #  ##   ## #  # #   # ##   #### ##  # #       ### #### ## ##,  # ###     ##     # # ####....###....#.#..#
### ### #### ##  ## ##### ###  ### ###### # ## # ##        # #  ##,####### ## ##  # #     # ############.....##
#   ##     #  ##  ####    ##  ##            ## ###  ## # ### ## # ,,,,,,,,  # ### ### #####  # ###     #.######
## #### ## ##  ## ## ### ##  ##### ###### #  ####  ##  ###   #  ## ## ###,###  #####      ## # # # ### #......#
#  ##   ###### #  ##      ##  ## ###      # ##    ####   ### ## ##  #### ,,,####   ## # ###          ###.#.#.##
## ## #   # ## ##  ## # #### ##   ### ## ##  ### ##    #######   ## ## ## #,,### ######     ## ### #######.#.##
#  #  # #   ###### ## #  ##  ####     #  ## ####### ##     ##  ####     # ##,,,,    #### # ##    #      ####..#
# ## ## # #      ###### ####   ## # ### ### #  #    #  # #  ####    # ### ## ##,###    # ##### # # ## #   #####
# #  ## ### ## ###      ## # #### # #     # ## ## # ## # ##   #### #####   #  #,  # # ##   ##  #####  # #     #
### ##   ## ##  #### # ##    ##   # ### #####     # ## #  # # #  # # # # # # ##,#######  ##### #   ###### #####
#    ## ##  ## ##    # #  ## ### ## #    # ### ## #### # ## # ##       # ### # ,,#    ##  # ##### ## #  #     #
### ##   ## #   ## # # # ### # ####### #    ## #  ##   #  # ##### # # ##   # # #,  # ####    ## #      ##### ##
##  #  #  # ## ##  ### # #     ## ##   # # ######  ## ## ##    #### ###### # # #,##### ### #      # ##    ##  #
#  ### ## ######## ### # # ## ##   # # # # ##     ### ##### ####     # ##### ###,,,##    # # ### ##  ## #######
# ###  #       # # #   # ######  #   # ### #  ### #       #    ### #      ##   # #,   #### #  ## #####   # ## #
#   ## ## ## ###   ## ## #  #   ## # #   # ###### # ## ## # ## #   # # # ##  # # #,# ####### ##      ###   #  #
# # ## ## #    ### ## #####   # #  ### ##### ##   # ##  # #  # ## ######  ## # ###,###     #  ## # ###   #   ##
# # #  ## ## ###    ###     # # # ##   ## #     # # ### ######### # # ## ##  ###  ,,,,,### ## ## # # ## ## ####
# # ##  #### #### # ##  ## ## ### ## # ##   ## ## #  ##  # # ##       ##  ##   ### # #,,,#### ## #   ##  #    #
# # #  ##       # # ## #####   ##  ### ### ###### # ####      ## # ####  ##  # ##  # # #,   # ## # #  # ## # ##
# # ##  ### # # # ###   ##   # #  ##    ## ##     #   ### # #### #    ##  ## ##### # ###,## ###  # # ## ####  #
# #### ##   #############  ###### #  # ### ###### #####   #  ##  # # ##  ##   # ## # ###, ##########  #   ## ##
###     ###      ##       ##      ## # ##  #         ## # ##  ## # # ###  ###   ## #   #,###  ### ### # ###   #
##  ## ##   # ########## ##  # ## ## #  ## # ## # # ##  #  ##  # ###  ###  ## # #### # #,,,## # # # ######### #
#  ### ### ## #   # # ## ### ####  ####  # #  ### ##### ##  ## #  ###  ## ### #  ##  ### #,,,,,,,,,       ##  #
## ##  #   ## # #         #####   ##    #######      ## #  ### ##   ####    # ## ###  ## # ### # #,##### #### #
##### ## #  ### # ### # #  ###  # #### ## # ##### ## #  # ## ###  #    ## # ###   ###  # #  ## # #,    # ##   #
#     ##### #   # #   # # ## ## #  #####           # ## #      ## ## # ## #  ## ###   ## # ##### #,### #### # #
##### # # #### ## # # # # #     ####  ### ## #### ##### # # ####  #  #### ####   ### ### #     # #,,,#####  # #
#           ## ## ### ### ## # ######     ## #      ##  # #    ## # ##       ## ##     ### ####### #,,## #### #
##### ## ## ## ## #    ## ## # ##   # #####  # # ##  ## # # # ##  #  ### # # #  ## ## ####      ## ##,,,,,,,# #
## #   # ## ######### ############# ### #### # # ## ##  # # ##### ###### # # ## ##  ###    #########  ## ##,###
#    # # ##     ##    ## ## # # #    ##      # # #   ## # #    ##   ##   ### #   ##  #####         ##  #  #,###
## #####  # # #  ######           ##    # # ## # # ###  ### ##### ######   # ## ####  #### # ######### # ##,, #
##   ##  ## # # ##      # # ## ## ### ##### ## ###   ##   #     # ##     ### ##    ##    # #        ####  ##,##
#  #  ## ## # # #  # ## # # ## #  #   ##     # #   # ## # ## # ##  ## ##   # ## # ##  # ## # ## # #    ##  #,,#
#############################################################################################################,#
