#.#############################################################################################################
#..................#.#.#.#..##.#.#.#.#  # # # ## # #    # # # #   #  #           ##        ##  # ## # #       #
### # # ## # # ###.......#.##..#.....##     # #    ####       ### ## ### ## ######## #########    #     ##### #
#   ###  ########## # ##.#..##.#.########## # # ####    # #####      # # ####  # ##  #       ## ### ####### ###
# #########.#.....#####..##......#.#.##  #    # ## ### ##### ## #### # # # ### #  ## # #######          #    ##
###...##.#....##.###.###.#..######.#..## #### #  # #     ##   ####          ## # ##  #    ##   ### # #### ##  #
#...#..#.###.###.##........##.#.#..#.##  ###    ## #### ### #### ###### ###       ##   ## ####   #######  #####
######.....###.#.#####.# #....#.##.#.## ## ####  #  ##    #  ##   ## #   #### ###  ## ##### #  #  #### ##     #
#......##.##...#..##.######.###.#....## ##  # # ## ### #### ##  ###  # #  ###########    ##   ###  # #    #####
##.#.####.####.#.##...#.#.#..##.###.### ## ##      ##  # ## #  #####   ####      ## # ###### ## #### # ## # # #
######..............###.#...##..#.#.#.# ## #### ## ### # ## # ##   ### ##   # ##### # ## ##            #### # #
#.#..##############...#.###..##.#.#...# ##  ##  #### # # ## #  ## ## #  ## ######      # ## ######## ### #    #
#...###.............#.....##.##.....### ## ####  ##  #    # ##  # #  # ##       ##### ##     ###  #####  # ## #
###.#.#.##.###.#.#.##.##.###.##.##.###  ##  ####  ##   #### #  ## ##      ####### # #    # #   # ## # # ## ####
#.....######...#.#..####......#.##...##  ##  ##  ##  #    # ##  #  ## ######   ## # ## #########         # # ##
#.#.#.##.#############...#.##.#..#.#####  ##    ######## ## #  ## ###    # # ###  # #    ###   # # # ##### #  #
#####..#.....#####.....######.#.######   ### ###### #  #    ## ## # # #### #   ## # # #### ## ## ######  # # ##
##.###.#####.#.#.####.##..........## ### # # #  ##  ##   ## #                ###  # #  #    #  #  # # ##      #
#..#.......#.#........#..####.###### #         ####  ###  ##### ####### # ## #### # # ## #### ## ## #  # # ####
##.#######.#.#############..,,,## #  #### # #####   ## ##  ## #    ## ######## ## # #     # # #  #  # ####    #
#.....#........##.##.#.##..#,#,,# ## # ## #   # ### #  ### #    #####    #  ##    #   ###       ## ##  ##  ####
#####...#.####.#..#.....####,##,# #  # #### ###  ## # ## #   # ###  # #### ######   ######## ####   ## ## ### #
#.....######.#.##.###.#..##,,# ,,,##    ##  # ## ##   ##   ##### ## #   ##  # # ###  ## ## ### #  #           #
##.####..#............##.,,,#####,## ###### # ##  ### #  #### #  ##   ###  ## # ##  ##   #  #  # ####### ######
#### ###...#.#.###.#.####*# ## ##,##  # #     ###  #  ##      ##  # ### ## ## # ###    ### ## ## # ##  ### ## #
# #   ###########..#.# #  ###    ,,## # #####  ### ## ## ######  ## ##     ## #  ## # #### ##  # #  # ###     #
#   #  ## # # # ###### ######## ##,,#   ## #  ##   #  ##   #### ##   ### ###  ##  # #### #  # ## # ## # # # # #
###### #  #       # #  # #       ##,### ##   ##### ## #  ###  # ####  #    ## #  ##  # #   ##  # # ## # ### ###
# ##   ## ## #### # ##   ###### ## ,,,, #### # ##     # ## ## #  ##  ## ####  ## ## ## # #### ## #       #   ##
#  ### ## #####      ## ##   #########,## #  #  #####      ##   ####       ## #             # #    ## ##   #  #
##  #     # # ##### ##   ### # ##     ,,,,## # ## # ## ###### ### ## ######## ## ####### #### # ######### #####
### ##### # # ## ## #### #      ###### ##,#    ##      ###  #   # ##     ## #  # #     #### #   #       # # ###
#   #            #   #   ### #### ######,,### ###### #   ##   ### ### ####  # ##   # #  # # # #   # #####     #
### ###### ## ## ### ### # # # #        ,## # # # #### #### #####  ## ## ## # ### ####### # # ## #####  #######
### # # ##### #       #    # # #### ####,,,,,,#   # #   ##   #  ##    ##  # #       # # #      ####  ## ##  ###
# # #   # # ### # ### #### # # ## ### #### ##,# ### ## ### ### ##  ####  ## # ### #       ## #### ##    #  ## #
#   ### # #  ######     ## # # ## ### # #####,# ##  #    #  ##  ##  #### ##     # ###### ### ##   #  #### ##  #
###       # ## # ###### #                 # #,# ### # #### ####  # ## ## ## ######## ##### #### ### ##### #  ##
# # # ###           #     # # # ## # ## #    ,# #       #   # ##   ##             #     #  ## #      #  # ##  #
# ##### ########### ##### ### ###############,,,###### ## # #  ###    # ### # # #   ##### ##    ## ### ##    ##
#  # #                     ## ##  # # #  #### #,## ### ## ### ## # ## #  ##############    #### ## ###  ### ###
##   # # ## ## ####### # #  ##### # # ##      #,,# # #  #  ## #     #### # #  ## ## # # ####  # #### # ##     #
#  #   ######  ##      # # ######     ##### ####,,,,,, ## ### # ## ####      ##            ##   # #    ## #####
# #### ### #####  # # ## #### ##  # #   ##  ##   ####,### ##     ###  ##### #### ### # # ##### ##   ####   #  #
###    #    ##   ## ####### #    #### #  ## #  ######,# #  # ###   ##    ## ## #  ######### ##  ###    # #   ##
###########  ### #  ##        # ###   ##    ## #     ,# # ##  ### ##  # ###### # ## # # # #  ##  ## #### ######
# ##### #### ### ##  ##### #### # ### ### # #  # # ##,,,  ## ## #### ##### #                ##  ##            #
#                #  ##     #    #      ################,#### ##  ##   ## # ## ### ######## ####  # ## # #######
# ########## ## ###  # # # # # #########    ### #      ,# #   ## #  ###  # ## # #        #######   ####       #
# #          ## ##  #############   ## ### ## # #######,#   ###    ## ##        ##########  ##   #    ####### #
##### ## # # ## ### # # # # # # ###        ## # ## ## #,# ### ## #### ## ##### #### #    ## ## ### #######  ###
#     #  ######## # #       # # # ###### # #    #      ,,,,,,,,             ##### # # ####       # ###     ####
##### ##### # ##  #########            ### ####   ##### # ## #,# ##### # ##   # #   # # ## # # ###     # #  # #
#     ###        ###        # ########  #       # #     #  ###,#########  # # #   #        # #  #### # ###### #
#### ##   # #### # ## # ## ##### #  ###   ### ##### ## ###  ##,      ##  ####   # # # # ## # ##   ## #  # ##  #
## ###########     ##########    ## # ### ###### ## #### # ## ,## ##  #####   ### ### # ## # #  ###  ##      ##
#   # #### # #####   # #    #### #        #           ##    ##,######  ###  ###########  # # ##   ####  ####  #
###           ###### # #### ##     # # ########## # # ## # ## ,  # ###   #####      ##########  #    ##    ####
#   # ## # ##                ####### ####         ###  # #####,###   # #  ## # ###### ### #  ##### # #  # ### #
#######  ##### ## # ## # ## ## ######## # # ##### ##  ####    ,,,# ########        ##       ## # ### ## #     #
# ## #  ##     ## ######### #       ##  ######     ##  ##  ### #,,,# ## # ## ######## ### #        # ## ## ## #
#      #######  #### ##   # # # # #  ##  #     ## ### ######   # #,,  # # ##   #### #   #### # ## ## #   ###  #
# # # ##       ##       #     ###### ###   # #### ##   ##    ### ##,### #  # ###      ########  #  ########## #
# ### ### ## # ########### # ##  # # # ### #### #  ## #### #  ## # ,# # # ##     ####  #  # #########   #   # #
####   ## ###### ###############           ##     ##    ## ####  ##,,,,,,,,,,#########   ## # # ##  ## ## #####
#    # ## #   #         #   # ##### ### ##  ## ## ## # ##     ##  ## # ### #,,,,,,   ###    # #  ## ##      ###
## # ######## ##### ### ###   # ######   ####  #  ## ##### # ##  ##  #  ####### #,########### # ##  ### ##### #
#  #### ## #   ## #####     #          #  ##  ## ### ##    #######  ###       # #,  #   ####,,,,,## #   # # # #
# ##    #    #    ###   # # ## ## ### ### ### #### # #### ### #  ##  ## # #######,### ###,,,,# #,,,,,,###     #
# ##### ###### ##     # # ####  ###     ### ###    ###          #### #  #    #  #,,,,,##,,# ## # ## #,    ## ##
# #         #  #  ## ## ###    ##   ## ##    ##### ###### # ###   ## # ## ##   ### ##,,,,## ## ###  #,### ##  #
# ### ### #   ### #   ######## ### ######## ## ##     ### #   ## ##  #  #  # #  ####  # ###  #   ## #, ##  # ##
### #########   ### # ##       #   ##  ## # ## #  # #     # # #   ## # ## ## # ##  ## #   # ## # ## #,### ##  #
##            ####  ##### # ## ## ##  ##         ## # ## #### # # #  # ####  #    ### # # ######  # #,, # ### #
#  #### ### #### # ##     # ## #   ##    # # ## ### # ## #  # # # ## #  #### ### ## # # #   #  # ## ##,####   #
#### ##########     ## ########## ##  ## ### #    # ####   ## # # ## ##    #  ##    ##### #   ####### ,# ### ##
#     ##      ########## # # ## ###  ##   ##### # # #    #  # ###  #### ################### ###  # ###,,,,#####
#### ########   ### ##       #   ## ##  # #     ######## #### ##  ##                  #  ##     ##   ## #,    #
#    ## ## ### ##    #######   #     ## # ## ##### # ###  ###  ##  ## ## ## ## ######## #### ##    # #  #,### #
#### #   # # # ##### ##      #### ## #  # ####           ## ###### ## ## ## ##          ## ########### ##,  # #
# ## ### # #          ##### ##    #  ## ### ## ### ### #       # # #  ## ##### # #########         ###  #,#####
# #          ###### #       ## ## ##  # #      #   #   ### ##### # ## ##     # #   ## ## # ##### ### # ##,,,,,#
#   # # ############# # # #### #  ### # ### # ### ### ##         ###  #  ## ## # #            ##     ###  # #,#
### #####             # # #    ##  ######## # #   ##  ## # # # #   ## ##  #  # ### ## # # # ###  # #   ## ###,#
#   ## ###### # # ### # # # ## #  ##        # ## #### #  # # ### ###  #  ### #   #  # # # #   ## # # # ##  ##,#
# # #         # # #   # # # #####  ## # # # # ## ##   ## ###   #   #####   # # # ## # ### # #  # # ###### ## ,#
# # # # ### # # ##### ### # #     ##### # # # ####### #    # # # #  ##   ##### # ######   ### ## #   ## #  ##,#
# # # # #   # # #       # # ## # ##     # # # #       # # ## # # ## ## #     # #     ## #   #  # # #    # ## ,#
#############################################################################################################,#
