#.##############################################################################################################################
#.......##.##.....##.##.##.#.#     ## # ##   ### ## #  # ##   #  ## #  # ##   ##   ## #  ## ####   ## #  #      ##    # ## #   #
#####.####.##.#####..........#####      ####  #  ## ## # #  # # ##  ##    ## #### ### # ###  ##  #### # ## ####  ## ### ## # ###
#.##..#.#...#..##.########.###     ### ##  # ## ##   #     ## # ### ## #####  ##    #     ## ###  ##       #######  ##   #     #
#.###.#.###.#.##...##.#..#...########   ## # ## #### ##### ####  ## ## # ##  ##  # ## #####   ## ### #####     ### ### #   ## ##
#...#.#.##....##.###..##...#.##   # ###    #  # # ## ## ##  ##  ##        ##  ## ###  ##  ### #         #### ### # # #### ######
#.#........#.##....##.###.####### # # ####   ## # #   # ## #### #  ########## ##  ### ## ##     ### # #  ###     # # ## # #    #
#.##.# ### #..#.####..#.#.#.## #        ### ##  # ###   ## ## # ## #      ##  ## ## #  #    ###   # ####   ### ### # ##   # # ##
####.########....#.##.#...#.#  ###### ###    ## #  #  ###  ## #  #   ####  ##  #    # ## ####### ## ##### ######     ## ### ####
#....#...##.###.##.##.###.#.##          ### ##  ## ##  ## ##  ## # ### #######   ####          ###### # ###   #### ###       # #
########.........#.##.#.#....##### ####  #   ## ## ### ##  ##       #     # #  #   ## ### ### ###  ##    ####  ##   ## ## ##   #
#  ######.######.#.##.#...####..##### ## # #     # # # #  #########   # ### ## ### ## # # ######  ##  #### ### ## #### #########
## # # #########.#.##...####.##.#.#      ### # #     #   ## # ## #  ##### # #  #####    ###  # ## ## ## ##  ##    #  #        ##
#  #   #............##.####..##...######   # #######   ###    ## ##  # #    # ##   ####  ## ##  # #      ## #  ## # ## #### #  #
## ### #####.##.# #.......##.##.#..####  ########  ###  ### # #   # ## #### #    #####  ### ## ## # ######  # ##### ##    ######
#       ## ##############.#..#####.#  ## #  ## #  ## ##  #### ## ##  # ## # # #### # ##  #  ## #       #### # ####     #########
#######     # #####.......##..##...## ## # ##  ## ##  ##  ##  ##  ## # ##   #  ##  #  # ## ##    # ##### #     ##  ## ##### #  #
### # #####   # #...##.##..#.##..###   # #  ## #  #  ##  #### ## ### # #### # #### ##   ##    # ###### #   #####  ##      #   ##
#     # # ### # ######..##...###...### # # ##  ## # ##  ### #    ##    # ##    ##  ## ###  ###### ## # ###   ##  #### # #   ####
## ##     #     # ## #######.#.#.###          ##    ###   # ### #### ### #  ##  ## #    ##    ### ## # # # ###  ### #######    #
##### # #   ### # ## ##............###### ###    ## # # ### #    ##   ## ## ###### # ####  #### #  # # # # # # ###   # # ## ####
#     #### ##     ##  #########.####   #### #######   #  ## ## ##### ### ## # ## # # ## ## # ## # ## #           # ### #  ###  #
## ##   ######### ## ###.##.#....#   ### #     ## ###   ##  #  ## #  # #  # # ## # # ##  #        #    # # # ## ## # # # ###  ##
#########          # ##*,,#.####.### # # ##### ## # # #  ## ##  # ## #   ## # #       ## # ######## ########  #          # ##  #
# #  ###  ########   #  #,,,,##...## #                ##### #  ## #  # #### # ## # ##### # # # ## #      ##  ## ## # ###      ##
# ##   #### # #    # #######, ###.#  ########### ####  # #  # ### ## #  # #   ## ### ##         #   ######  ########   # #######
#  ### ###    ###### # # # #,##.#.## ### # ## #### #  ##   ## ##     # ## # ###   #  ## #######   #    # ##     #  ## ##       #
# ## # # ####     #         ,,,,,,,,,# # #      #    ##### ##  ##### # ##    ####   ##  ## # ####### ### ## ##### ###### ### # #
#        ## #####   # #### # ### ###,#,,,###### #### # #   ###  ## # # ## #### #  #####            ###    ###        ##   ## # #
##### ##          #####    # ###### ,,,#,,,## # # ## # ###  ## ##      ## ## # ##  ## # #### #####     # #### ########  #  # # #
###   #  ## ## # ###    # ## #      ## ###,,,,,,,,,,,,,# # ##   ### ##  # ## #  ##  # # ####     ### ### #           ## # #### #
#   # ## ##  ### ##  # ##  # ## # #  ##### # #### # ##,,,,,,## ## #  #### ## ## ## ##      # # #  ##  ##   ## # ### #######  ###
### # ## #####    ## # ### #  ### ## #     # #    # #  ####,#  ## # ###    # #  ##    # # ## ####### #### ############ # ## ####
### # ## #     # ##  # # #######   #### # ############ #   ,,,##  #   ## ### # ##  # ######        #    ###### #   #           #
#   #  #########  ## # #  # #    ########  ##  ####  ########,### # ###  ##    #  ##      ########### # ## ##    ### ###########
# # # ####       ##  ####   ## # #   ##   ####    ## ## #    ,,## #   ## ## #### #### # ###   #    #### #  ## # ## #   ### # ###
### # ##   ### ###  ##  # ########## ########## #    #    # ##,## # #### ## ###     ######  ### #### ##### ## ###    ###   # # #
##  # #  # ##   ####### # # ### # ## # # # ## ###### #########,#         ##     ###### # ##           ## #  # #### ##### ###   #
#  ## ## # ######            #  # #        ## #####      # # #,,,#######    # # #   #  #  # ####### ###    ## # ##  ##       # #
## #  #### #      # # # #### ##     #### ###  # # # ####     ###,,# # #### ####   ### ## ## # ########## ###       ##  ## # ## #
## # ##    #### # ### ####   ##########    ##     #####  # #  ###,,,,    #   #######               ## #      ### #    ##### ## #
#  #  ## # ###  # #   ## ### # #      #### ###### ##  #### ##     ##,#######  ####   ########## ## ## # ## #  #### ####   #### #
# ## ##  ###   ## #####          ### ##            ##       ### # ##,     ###      ###   # # ########    ####   ##   #  #  ##  #
# ############ ######   ## # ### ##  ############# ####### ##   # ##,# # ##   # # ## # ###     ## ##  ##### #####  #   ###  # ##
#  ##  ###   ###    ###  # #########   # # #  ###      ###  ## #### ,######## ###          ###     ##           ## ## ## #######
# ### ## ### ######  ### ####  ## #  #     ## # ######     ##     ##,      ## ##  ## ## # ######## #  # ##### #  # ##          #
### # #  #      ####  ####    ### ######## ##     ###### ##### # ## ,# #####   ##  # ## #    ### #### ### ########  # ##########
### # ##   # ## # #  ## #####  #    ## ###  #####          ##  # ###,#    ## ###  ##  # # ##      ##   #    ## ### ##  ###     #
#     ########  # ## #  # ####   ##        ##     ##### ##  ## ###  ,# # #####   ### ## #  # # ##    #   ##  #   # ###     #####
## ## # ##  ###   ## ##   # ######  # ####    # ####### #####  ### #,#####   # #   # ##### # #### ## # #####   ##### #####  ## #
####     ## # ###     ### # # # #  ######## # # #       # # ## #   #,,,##  # # ## #### # ### ###   # #     ## ### ## ### # ### #
# ### ##    #  #  ###             #####     # # # # # #      # ### # #,   #######          #   ######## # ##       #     ###   #
#   ####### ## ######## # ###### ## #   # # # # ### # ## # #####   # #,##   # ##  # # ### ## #      ##  ####### ##   ###     # #
## ### ###     # ## #######      #    # # # # # #   # #  #  # #### # #,,###    # ## #   ####### ###  ##### # ## ## ###   ## ## #
#   #      ###   #     # #  # ## #### # ####### ### # ## ##      # # ##,  ## # ####### #### ##    ##          # ##   ######### #
### # ## # ##  #   ###     ## #  ##   # ##      ##  # #  #  # ## # ####,###  #### ##    # #  ## ##### # ### # #  #####     # ###
#     ####  ## ##### ## ## ##### ### ##  ###### #  ##### ## # ## ####  ,# ##      ## ##     ##      # #  ## ####       # #   ###
####### #####  ##       #   ##   #   ## #####   ## #     ####  #  ##  #,,  ######  # ## # #  ### # ## ##  #    ## # ## # # ### #
#######       ####### # ## ##  # # #### ##    # ## ## ##  ##  ##########,#      # ## #  ### ######  #### ## ##  # ##########   #
#       #### ###      # ## ##########   ### ### #  #   ##  ## ##     # #,#### #####  ##   #    ######  ############## # # ## ###
# # # # ###### ##### ##### #          ### # ##  ## ### ## ##  ######  ,,,   #     ##  # # # # ## ## ##           #             #
# # ### #       #    ##    ### ##### ##      ## ## #   #   # ## ##   #,# # ## # ##### # # ###  #       #########   ### # # #####
######  ### ###   # #### ### #####   ##### ###   ##### # # ###     # #,# #  ###     # # #   ##   ## ##         ###   ##### #####
#      ##   #   # #    ###    #    # #      ### ##     ######### # # #,####  ## ## ####### ##  #  #  ## # # ################   #
##### ##### ######### ####### #### # # ## #   # ## # #  ##       # # #,,,###########   ##   ## # ## ##  # # # ##       # ### ###
##  #### ##### # # #####       #   ######## # # ## ####  # # # # # ### #,,,,,,###    #### # ## #  ##### # #    # ### ### # #   #
#  ##     ###    # # # ##### #   #  ##      # # #  #    #### # # #  ## # # ##,,,,,## ###  ###  ## ##  # # ## #     ####      # #
##  ##### # ## #             ## ### ### # # ########### ##   ######  # # # ## # #, # # ##  ## ##     #### #  ### #  # # #### ###
###  ##        ### ### ### #  ####  # #####   ## ###    #### ##     ## # #  # # #,##    # ####### ##    ######   ##        #   #
####    ## ### ###  ####   # ##    ##  #### # #  #   # ##     #### ##### # ## # #,,######## ###   #  ##  # ### # ## ######## # #
## ## ######   #   ##    # #######  ##  #   ####   # #  ### # #     # #  # ## # ##,           ### ##  ##     # # ##    ##### ###
#     ## #   # # #  ## # # ##      ####   #  ##  # # ## ##  # ### #   ## ###  # ##,##### ## #  ##### ##  # # ### #  ####   #####
## # ##    # ##### ##  # #  ##### ### ### # #### # # ##  ## # #   ## ###   ## # # ,,,#########  ## #########   ####      #  ## #
#  ####### ###      ## ### ###### # # #   # #    # # #  ##  # # # ##   # ###### ## #,,,###   ##  #       ##  #####  # # ###    #
#####      ###### #  ####  #      #     # #### # # ####  ## #####  ### ##### ##### # #,    #####   #####  ##     ## ######  ## #
#   # # ##   ##   # ####  #### ## # # ### ###  ### ##   ##  ##    ##          ##   # #,# #     ###     # ### # # ##    # ## ## #
###   # #### #  ### ## ##################   ##  ###### #### #  ## ## # ## ###  # # # #,### # #  ## # ##### # # # #  # ##     ###
#   # ###    ##  ## #  # # # ##  # # #    #####   ## # ##   ## ##  ###  #   ## ### # #,,## # ##  # #       # ###### #  ### #   #
## ######## ##  ##  ##        ##       ## ## #### ##   #  # #   ##   ## #####   ## # ##,,####### ### #### ##   ###  ##  ## ### #
#   ##       ## ####### # # #    ## # ##        ###### ## # # # ### ##      ## ### # ###,   # ######    #### #   ###### ##  ## #
####### ## # #### ######### ## #  ###### # ## #  ##    ## # # ###   #### # ##    ### #  ,####      ## #    # ### #    # ## ### #
#        ##### ## # ##       ### ##      # ## # #### #  # ### #####    ###  ## #  ######,#,,,,# ##  # # # ## ##    ## # ##   # #
#### ###### #        ##### ###   #### # ##  # # ##   ## # ##### ##  ########## ##   ##  ,,,##,########### ## ## # ##### #  # ###
###### # #  ######## ### ###   ###    ###  ## #  ###  ##### ##     ##### ###    # #  # # #  #,       #  #### ## #   ### # ######
#   #      ## #              ###### #   ## ## ## #   ##     #  ###     #   # ## # # ## # # ##,######## ### ###  # #   # #      #
### #### #      # # #### # # ##     # # ## ## ## ########## ## #   # #   ### ## # ###### # ##,,,,# # #     #### ### ### # # ####
#        ## # # ######## ######## # ### #  ##  # ##   # # # ##### ## ## ####### #   ##   # ## ##,,,,,,,##### ##   #   # ###    #
###### ###### # #        ## #   ###   #### #  ####  #             ## ##       # # ###  # ###   # # ###,,,     ## ## ###  ## ## #
#       ##    # ### # ## ## ## ##   # ##   ## # ############ #### ####  # # #####   #### #   # ###  ## #,#########    ## ## #  #
###### ### # ###### # #  #        ### ## #### #  # #  #      ###   #### # #   ##  #  ###### ##   ## ## #,,     ######  # #### ##
#        ######     #### # # ## # ### #####   ## # ## #### ###   #    # # # ########     ## ## # #  ## ##,## ### # ####### #####
#### # ###  # #### ##    ### #  #   # #     # ##           ##  # ## ### # #       ## # ###  ## #### ## ##, #####       ###     #
#    ###### # # ####  ##  ## ## ## ###### # # #### # ##### ### # #    # ### ### # ## #   ##  #  ##  ## ##,##     # # ###   # # #
# # #### #       ######  ##  #####  ##    #####    ######   ## # # # ## #    ########## ##  ## #### ## # ,,### ####### # #######
###### # ###### ## # ###  #### ##  ##  ## ## ##### ##     # ## # # ###  ### ## # ##   #  ## ## # ##  ### #,# # ## #### #       #
#  #                     ## #     ##########       #  ### ###  # # ######           ### ##  ## #    ###  #,,,,,,,,,# #   # # # #
## ## # # ### ## # ## # ### ### #   #### #   ## ## ## #     ## # #   ##   # # # #############  ### ###  ## # # # #,,,,,####### #
#     ####### #  #  # # ##  #   ## ##      # #  ## #  ## ## #  # ## #### ## # #       ##    ## ##    # ### # # ### # #,,# ######
# ## ##       ## # ## #  ##   #  # ### # ### ## ## # ##  #### #####    # #  ##### ###  # # ##  ## # ####   # #   ######,   #   #
# ####### # # #  #  # ## ## # ## ### #####   #  ## #####  ##  # #   # ##### ###     ##   ##### ## # #  ### # ## ### ## ,#### # #
###       # #### ## ###  #  #  # ### #  ### ### ## ### ##  ##   # # # ##      ### #  ###  # ##### #   ## ### ##      ##,     ###
#### ### ####    #    ## ## # ####   ##     #    # #      ### # ### #  ## # # ##  ##  ## ## # # ### #     ## ## ## ####,# # ####
#    ##  ##   # ### #### #  #   ## #    # # ### ###### ## # ###  #### ##  # #  ## ## ##         ### # # ###  ##  ### # ,# #    #
### ####  # # ### #    #### ## ##### # ####  #### # #  ##     # ## ####  ## # ##  #   ## ######   # # #   ##  ###### ##,### ####
######   ######## # ######  ##  ##   #  #### # #  #   ##  ## ##       ## ## #  ## ## ###      # ### # # #  ##   #    ##,###### #
# #    #  ###       ##     ##  ##### #### #  # ## ## #### ##  ## ####### ## # ##  ##   # # # ##  ## # # ## ## #   ##  #,,,     #
#   ## # ## # # # #  # ## ####  ##    ##    ## #       ##  ## ##     # # ## # ###  # # # # #  # ##  # # #  ## ## ##  ## #,# # ##
## ##### ##   # # # ## #   ##  ##  # #### # #    # # # ## ##   # ## ## #### # #   ## # # # # ##  #########  # ## ###  # #,######
## #     ## ### ###  ### ######## ##  ##  # ## # # # # #   ## ## ##       # # ###  # # # # # ###  ## # ##  #####   # ## #,## # #
#  #### #####   ##  ##     ## #   ### ######## ### # #####  ###  ## # # ### # #   ###### # #   # ##     ##   ##  # #  # #,,  # #
## #     ##   # ### ### # ##    #  ## #      # ##  # ##    ##   ##  ###   # # ###  ## ## #### ##    ####### #### # # ## ##,#   #
###### #  ### # #     # # #  # ## ##########    ## # ## ## ## #  ##   ## ## # ####    ##   ## ## # #####  #### # ### ## ##,## ##
#      # ###  ### # # ### ## ####   ###      # ##  # #  #   #### #  #  #  ##### ## ## ## # #   # #       ### #    ####  # ,## ##
## ### # # ## ##  ### ########    #   ###### #  ## # ## # #   ## # ######  ##       # ## #### #### # # #     # ##    # ###,##  #
#  #   ###    ######     ## ##### # #  ##    # ##  # #  #### ### #     ## ###### ## #  #  ##  # #### # # # ### ## # ####  ,,## #
## ## ####### #      # # ##  ###  # # #### # # ## #####  ##  ##  # ###### ##      # # ## ####      # #####   # ## ###    ##, # #
#   #### #### ## ### ###  ## #   #### #    # # #      ##  ## ## ##      ###  # # ## ###     ### ####   ### # # ##   ## # ##,## #
## ##         ## ##   ## ##    #    # # # #### ## # # #  ###### #  #### ##  ## #  #  ## # ###      # #   ##### ## #### # # ,,###
#  ### # ## #  ###  ######  # ## ## # # #  ### ## # #### #      ##  ###  ## ## # ## ##  # #### ## #### #    ##  # ## #######,, #
## #   # #  # ##   ##  ##  ## ## ###### ## # #  # #   ## ## # # ## ## #######  #  #  ## # #    ##    # ### ##  ##         ###,##
##### ####### ## #  ## #  ##  ##     ##  ###   ## ###  # #  #####      ##     ## ## ##  # # # ##  ## #   # ###  # # ## # ##  ,,#
#     ##       # ## #    ##  ##  ## #### #   # ##  ## ## ## ##    ## #  ## # ##  ##  # ## # #  ##  # # # #   ## # #  # #  ## #,#
##############################################################################################################################,#
