#.##############################################################################################################################
#.#.#.#.##  #  # ##     ##   # ## # ##   ##     ##  # #   ##  # #     # #  ## #   # #         # # # ##   ## ##  #       ## # # #
#...#.#..## # ## ## ######## # ##   #### #  # #### ##   #####   ## #### # ##    ### # #########     ### ##   # ## #######    # #
###.....##       ## ## ##  #   ### ## #    ##  ##   # #  ## # ####  ### #  ## ### # # # ###   ## ####      #       #####  #### #
##..###### #######      ## # ###   ## ## #### #### #####  # #  ##  ##     ##   ## # # #   # ###   # ### ##### ## #       ##    #
#..###.##   ## #   #######     ### ## #   # ### #  # #### # # ### ##### ##### ###   #   ### # # #          ######## ## #    ####
##..#...## ##  ## ### #  # #######    # ###  ## ## #  ##  # # ##  ##  #           #   #         ## ## # ####    # #### # ##   ##
###.#.###   # ##    # # ## ## ## ####     ##  # #    #### #    ##  ##   ###### ## # ##### ## # ########      #### ## #####  #  #
#.......# ### ### ### # #      #  ##### #### ## ## #  ##  # ##### ### ### ## ###  #    ####  #### ## ### ###### # #   ####### ##
####.##.#   #  ## # # # ## ##### ##      #       ####  ## #   # # ##  ###  #   # ### #    ####  # ##   ### ## # #   #  # # #####
#.#..###### # ### # # # #      # #### ## # ######## ##  # # ### #  ## # ## # ##### ########  ##      ##### #      ###### #     #
#.##.#.#.##    #  #   # # ######  # ###  # # ## ##  ### # #   #   ##          # #        ## ### ## #  ## # # ####### ###   #####
#.##...#.##### ##   ### #   ###  ##  ### # #     # ## # #   #   #  ### # # # ## # ##### ##       # ##  # #               #  ## #
#.#..###..##      #  ##   ### # ####  #    # ##### ## #   #### ###     ######## #     ##### ### ## ## ## # ##### # ### # ##    #
#...##.##..### ## #######  ## #  # ## ## ### # # # ## ## ### #  ## # #  # ####    ## ### #    # ####           #########  # ####
##.##...#.##   ####### #  ### # ## ## #   ##     # #         ####  # # ##  # # ########  # ###### ### # ## # #    #   ## ####  #
#...##.##..### # ##  # ##   # #  # ## ## #### #### ### ##### ## #### #### ##    ##  # # ##     #    # #  # #### #   ######    ##
###.##.##.## # # ## ## #  ### # ##  # ## ## #  ##  # #   #####     #####  ## ####  ## # ### ##   ## ### ##### #####   # #  #####
#....#.##..# #   ##  # # ###  #  ##    #    ##  ## #   ###  ### ####   # ### #  # ###        ########## # ##    ####### # ## # #
####.#..##.# # ###  ##   # ## # ##  #### ##### ###   ### ##   #  ##### # ##    ## # # ######  ###     #   #  ##    #           #
#....#.##..# # ##  ### ### ##   ## ####    ##    # #  ##  ## ## ##  #       ##             # ##   ### # #   ##  ##   # ### #####
####....##.# #  ## # # ##  #### ## ## # ###### ##### ### ##        ## ##### #### ## # ########  ######### # ######## #   #######
#.####.##..# ##  # # #  ## # ## ##  # #   ##   # ##  ##     #########     #    #  # # ##### ## ###    ##  #       #### #  #    #
#..#.#.##.##    ##   # ##    ## #  ##   # ####    ## ## ###### # ## # # #### ########              # ##  ###### #  ######## ####
##...#.#...#### #### #  #### ## # ##  ##### #  ####  #   # ##         ######### #  #### #### # ## ###### # ## ### ##    ###  # #
####.....#..###  ##    ## ## ## #  ##  # #  ## #  ##   # #    # #### #### # #   # ## #####################     ###### ### # ## #
# #####.##### ##  # ##### ## #  # ##  ## # ##    #### #### ####   ##          #        #     ### # # ## ## ##### ## # # # #  # #
# # ###...### ## ##  ## #  # ##    ## ##    ####  ##    #    ######### # ###### ### ##   # #   #      #    ## ## ## # #   ##   #
# # # ##.## # #   ## ##   ##  ## ###  #  #### #  ##  ##   ## # ###   ##########   #  # ##### # # ###### #####  # #      ###  ###
# #   ##.##   ## ##  ### ####      ## ##  # # ##    #####  #       #### #     ## ### #  # ###### # #  #  # #  ##   ## ####  ####
# ### ##..###     ## # #  ##  ## ###  ## ## # #  # ## ####### ######  # # ###  ### # ####   # #  # # ## ##   ##  ###   # # ### #
# # # ##.###### # ## # ## ## ######## ##        ##    #     #    # # ## # # ###### #### # ### ##      # #  ###  ## ###     ##  #
# # # #...#.##### ##    # ## #####       ###### ## #### ##### #### # ## #    ### # ##      #  ## ###### # ##   ###   ### #### ##
# #   ##.##.#.##  #  ####  #  ## ##### #    ########  #   #######    ##   #### # # #  ### ## ###     #       #     #####       #
# ## ##..##...### # ###   ## ##   # #### ####  # ####   #   ##  # ##### #### #       ## #### #   # #   ####### # # ### ### # # #
#     ##..##.##.#     ## ##   ## ##  ##       ## # #  ### #### ##     # ## #   # #####   # #   #######      ######       # #####
#### ####.......## ####   ## ##  #  ##  # ######     ######  #  # #####      # #       # #   ########## ##### # ### # #######  #
#### # ######.###  ## ## ##  ### ## #  ##### # # # #     ### ##         # # ##### ## ##### ##### # # ##    ##     # ### # #   ##
#       ##.....### ##  #  # ## # #    ## ##  # # #### #### # #  # ######### ########### ## # # # #    # ##    # ######      #  #
##### #####.##.# # ### ##    # #   # ###  ## #    # #          ##   ####  #  # # # ###  #          ## ###### ##  # ##  #########
# ##  # ######.# #  ## ## ####   ######  ### # #### ### # ###########    ###       # ## # ####### ###  #   ####### ## ###      #
#  ## #  # ##..#   ##  ##  #### ### # ##              #####  #   #    #### ### # # #  # #       ### ##   #####     ## #   #### #
# ### # ##  ##.## ##  #### # #  # # # #  # ### ###########  ## ### #######  ######## ##   #####     ## ### # # ######   #  #####
# ##  # #  ##..##  ## # ## # # ## # # # ####    ## ## # #  ### # # #  #  ##   # # ##    #     # ########   # # # ###  # ##     #
#  ##   ##  ##.## ### # #      ##         ##### ##  # # # ###        ## ##  # # # ## #### ### #      #### ## # #   # ##  #######
# ##  #### ##..## ##  # ### ##### ##### # #  ##### ## # # # # #### #     # ##           #  ##### ## ## #         #   ###       #
#  ##  ##   ##.#   # ##  #   ## #    #######   ##                # # ###   ######### # ###   # ######    ## ## #####   ## ## # #
# #### ## ###..### #  ##   #  # # #### # ##  # #  #### ## # # ###### #####  ### #########  #       ## #######      # ######### #
#  ##   # # ##.# #   #### ##### #   #    ## #####    #### ###   # ##    ## ##         # ##### # ##     ##   ## ######## ########
## #### # # ##.# # ###### # ##    ### ####    # # ##### #   #####  ## #  #    ## ###### # # ############# #  #   ## # # # ## ###
#   # # # # ##.#   #  ##       # ##     ## # ##         ## ####   ##  # ## ## ##### #        # # ###### # #### #    # # #      #
###   # #    #.## ## ##  ## ######### #### ###### # # ######    #############         ### ##                 ######       ### ##
#### ## #### #.#  ## #  #####   # # #       # #   ##### #    # ##      # ## # #######   ##### # # # # ### ##  # ####### # ######
# #  ##  ##  #.## ## # ## ##  ### #   # # #     #   ##    ## #  ## ##### #  #       # #    #### ### ###    ##         # #      #
# ## ### ###*#.#  ## #     ##   # # ##### # ## ## #  # ##########  ### # # ################# ####   ### # #### # # # ##### #####
# #   ## # #,..## ##   ## ### ### # # ##### ## #####          # # ##            #### #    #     ###   ###    ##### #   ##    # #
#   #    # #,#### #  ###### # ##        ### ##    ## ##### ####    ### ##########    # #### # ### ######## #    ##### #### #   #
# # ## #    ,,##  # ##   ## #    ### ##   ###  ##### ### #####  ####          #   ##     ## ####        #### ##   ##### #### ###
######## # ##,,## #  # #### # ##   #### ######## # #      ## ##  ### ### # #### #### ######  #   # ## #  ###### #  # #    ## ###
## # #########,## # ##  ##    ## #### ####     #   ### ##       ##     # #       # ###      ## ###########    # ##     ####### #
#    # ###    ,#     # ##  #####      ###  ###   #   #  # # ### ## ######## # # ##  #  # ####       ###  # ## # ## ###### # #  #
# ##       # #,### ###  # #### ### #### ##   ### ### # ## # ##      ### # ##### #  ## #####   ####### ## #  # # ## # ## #     ##
###### ### ###,### # # ##        ### ## ## #####  ####### ##### # #       ## #### ### # # ## ## # # #  # # ######         ###  #
#        ###  ,#          # #######      # ### # ##   # ##### ###### ####  #  ##        # #       # # ##   ##  #### ############
## # ### #   #,#### #### #####    # ####       #    # #   # # ## ##   ###### ##  # ## #     #### ##      #  ##   ##            #
##############,##,,,## ##### # #### ## # ############## ### #     # #           ######### #####     ## # ##  # ###### ### # ## #
####    ### # ,,,,#,,,,,# #            ####      ### #        ##### ### ## # #### # ## ##     ## # ##### #####  ## #############
## ####  #    # # ## ##,,,  ### ## ###### # ###### # # ## ###     ######## #            ##########    #### # ##  # # #   # ## ##
#   #### #### ### #  ## #,#   # ##      #    # # #     ###### # #  ## ## #### # ## ####         ####### ## # ## ##     # #     #
###      ##   ##  # ##  #,# ### ## ## #   ##     # ##### ## ########        # #  #    # ## ## #                  # #####   ### #
###### #  ###  ## # #  ##,########  ### ##### #### # ###    ###  # # ###### # # ## #### ##  # # ## ### #### # ##   # ### # ### #
#   ##### #   ##  # # ###,,,,,   # ######## #####      # #### ##       # ########     # ## ####  #   #    ###### #     ##### ###
# # # # # ### ## ## #   ### #,####                # ##   ###     ### #          #### ####    ## #### ### ### # # ######## ## ###
###            # ## # #   ###,,,########### ## # ##### #   ## ## ### # ## #####   ## #  ## # ##    # ##  #     #               #
#   ## # # ## ##  # # # #  ## #,,### # # ##########  #######   #   ###  #     # # #    #####  # ########   ## #### # # # # # # #
### ## # # #  ## ## # # ####  ##,,,,,,,,,,,,# # # ##   ### # ######### ############## ### ### ##### ## ###  #   ## # ### ### # #
###### # # # ##   #####    ##  #### # # # #,,,,,,,,# ### # # ## #    #  ####  ## # #### #   #           ### ## ##  #  ##   # # #
#      # # # ## ###     ######    ######### ## ###,,,,,           # ###      ##    # ##   ######### ##### ###########  # # # ###
## ## ######  ######## ###   ## #   ##    ###    # ###,################## ##  # ####    #####   ##### #    ##   # # # ######   #
####### # ## ####  ###     #  ### ###  ##   ## ###  ##,,,,,,,,## # # # ########      ####   ###    #    ##### ###   #   # ### ##
#             # ##     # # # ##       ############ ### # ## #,,,,,,             ########## ## # #### #### ##  # # #######   ####
## #### ## ##    # # ### # # ##### # ### #### ## #   # # ## ## ###,###### ### #         ## ## # ##     ##    ##           #### #
#  #    ##  ## # # #   # # #    ## ### #    #    # # ###### ##   #,     #   # # # #######        # #####  ##    # # # # ### #  #
###### ##  ##  # ### # # # # ## ##       ##   ######### # # ## # #,####### #### ####  # ## #####    ## ##  # ############## # ##
#       ##  ## #  ## # # # #  #  ## # # ### #   # # ##    # ## ###,     #### ##### ## # #      ## ####  # ###### # # # ## # #  #
# #### ##  ##  ## #### # # # ## ##  # #   #####        ######  ## ,####   #   ##   ##     ########## # ## # #           # # # ##
####   ## ##  ##    ## #######  ## ## # #    ## ######   # #######,,# ##### ###  ###  ##### #  # # # #        ## ##### ## #    #
#    ###  #  #### ###     # #  ### #### # # ###      ###        ###,    # # # # ## ## # ##    ## # #   # # # ##  #  ####    ## #
#### ##  ###   ##  ### # ## # ##      # # # # # ## #  ### ## # ##  ,##### #,,,,,,#,,,,   # ##### #   ###########   ## ### #### #
#     ## # # # ###   ###    # ### # # # # #   ###  ## # #### #  ###,#####,,,# ##,,,##,####         #       ### # #     ##  # ###
# ## ### #   #  ## #   ## ###  ## ###########   # ##     # ### ##  ,,,,,,,###  ### ##,,,   ## ## # # ## #### # #######    ##   #
###    # ## ### ## ### ##   # ##  ## # # # ###### ### ##     ###### ## ##   # ##   ## #,# ######## #  #### # # ## # ######## ###
#   # ####### # ##   # ## #######    #          #   # ## ###### #    ##########  # ####,# # ### #########      ## #   #        #
## ##   ##      #  # #  #     ##  ##   # # # #### # # #         ####          ####   ##,#     #  ###  # # ## #      #   # ### ##
#  #  # ## ## # # ## ## # # # #  ### # ### ### ###### ## ######## ## ## # ## ##### # ##,#####   ## ##      # # ### ## # # ###  #
#### ##  ###  # #  # ## # # # # ###  # #####       ## ##           # ## ###  ##  # # ##,,,  # #       # # ## #  ####  # #   ####
##    ##   ## # # ##### ### ###   ## ### #### ####### ## ## ### # ##  ######    #### ## #,### # #########  ###### ## #### #    #
#  # #### ##  ###  ## # ###   # # #   ## # ##       # #   #   # # ### ##   ## ### #   ###,,,###        ## ### ##   # # ####### #
# ##  # #  ##  ## ###     # ####### #         # # ##### # ######### #    ###  ### ## ##   #,  # # # ####    # #  #####  ##  ## #
# ###   # ##  ##  ##  # ###       ### # # ## ####     # #  ###   #  # ## ####      ########,### # #   ### ###   ### ### ## #####
#   ## ######  ## ## ##   ### ## ##   ### ##    # ### ####   # ### ##  #   ## ####### #  ##,####### #  ##     ####   #       ###
## ##    ##   ##  #   # ####   # ####  ##  ## # ######## # #    ##  ## ## ##      ##  ##  #,,,## #######  # #      #   ## ## # #
##### # ##### ## ### ##  # # # ###    ####### #      ##  # ## #    ### ##  ## ###  ##    ## #,,,,     ##### # # ##### ### ##   #
#     ###     ##  ## ## ##   #   #### #     # # ## #    ##  #### ### #######    ##    # ##  # ##,####     ### #     ####   ## ##
### #   ### #  # ##   # #  # # ###      #######  ### # ####### #      ## # # # ##  # ##  #### ##,,, # #####   # # #    # #  #  #
#   # # ##  # ##  ## ## #### #   ## # #       ##   ##### ###   ## ## ##    # ##### # ###    # ## #,##    ## # # # # # ## ## # ##
# # # ###  ####  ### ## ##   # # ## # ### # #### #####   # # ########## ## #    ## #   ## # # ## #,,####### # ############  # ##
### #   ##    ## # ###  #### # #### #  ## # #  #  ## ## ##       ## ##   # # ##  ### #### # #  # ##,,,    # #          ######  #
##  ## ##  # ### #   ##    ###    # ##  ###   #####   #  # #####       # ##########     # # # ## ## #,# # # #### # # #     ## ##
#  ##  ## ## # #   ##### ###   # ## ###   # #  ## # ### ## ### ##### # #  # # ### ## #### # #  #  ###,#####    ########## ###  #
##  ## #  ##   # #  ##     # # #  # #   # # ##          #          ########        #   ####### # ##  ,##  ## ########   #   ####
### #  ##  ## ## ## ### ## # #### ##### # #### # ### #### ### ######  #  #  ##### ## ### # #   #  ###,   ##### # # #  ##########
#   # ##  ### ##  # #   ## #   ##  # #  #    # # ##        ##### # ## # ## ## ###  #       ## ## ####,##### ##,,,    ######    #
## ##  ####    ## # # # ## # #  # ##   ## ## # ###  ## # #   #                  #### # ###### ## ##  ,,,,,,,,,,#,###### # ## ###
#  ## ##    ##  # ##### ## ######  ### ##  # #  ### ## # # #   ## # # ####### #    # #    # ######### ## # # ###,,,## #,,,##   #
## ##  #### ## ######## #      ## ##    # #####  ## ## # # # ######## # #   ### ####### #   ### # # # ## # #   # #,,,,,,#,,,,###
#   ## ##    #   ## # # ## ## ### ##### #    #####  ## #####    ###       ######### # #######   #   #  # # # # # # ####### #,# #
## ##   ### ## ###       # #### # #     # ##   # #####  ##   ##   ## ## #####          # # ## ### ### ## ##### ###      ## #,, #
## ### ##   ##   ## # # ##      ### ## ## ## #       # ##  # ##########       # #### #   # #        ###     ## ##  # ##  # ##,##
#   ## ### #### ##  # # ## # ## ##  ## ####  # # ### #  ## #    ##    # ## # ##   #### ###   ## ## ##### # ##  #  ## ## #####, #
# # ## #   ##   ## ## #  # #  # ### #   ### #### ##### ### ## # #  # ##### ###### # ##     #  # ##    ## # ### # ##  ##   ## ,##
# #  # ## ##  # #   # # ## # ## #   # #   # #       ## ##   # #   ##     #   ##      # ## ### # #  # ##  #   # #  ## ## #  ##,,#
##############################################################################################################################,#
