#.########################################################################################
#*,# ## ##  ## #  # ##  #  ## # # # # #       # #  ## ##   ##  ## ##   ##   ##  # ## ## ##
##,# ##    ##  ## # ## ## ###   # # # # ####### # ##  #  ###  ##   ## ### #####    # #   #
# ,,,### #####              # ### # # # ## ## # #  ## # ## # ### ###  # # # # # ##     # #
####,,##  ## # #### ######### # # #               ### # ##         # ## # #     ### ## # #
# ###, ##  # #####  ####  ##        ############### #      ### # #          ###   #  # # #
#    ,##  ## ##  ##    # ##  ########    #### # ##  ## ###  ## ### ###### ###### ## #### #
#####,## ##   ## ## #### ## ## # ##   # ##  #    ##  # #############   ######  ####   ####
#  ,,,##  ### ## #   ##  ##  # # #  ###### ## ######             ##  ### #  # ### ## ##  #
###,###  ##   ## # #### ####       ##  # # #    ##   ############### ##  # ##      #### ##
# #,, ##  ### ## # ##   # #  #########     # #######        # # # #  ## ## ## ########   #
# ##,##  ## # ## #  ### # ## #         # ### ##  ##  ##### ##   # # ### #       #  # ## ##
# #,, # ### # #  # ## #        ### ## ## ###  # ##  ## # ###  # # # #     ### #   ## ##  #
# #,### # # # ## #    ## ### #   #  #### # ##    ## #     #  ####     ##############  ## #
# #, ## # # #  #   ##### ####### ##  # ### #  #####   ##### ## #  # #  ##    # ###   ### #
# #,##    # ## # #####        ######    ## # ## ##  ####  # ## # ######## ####     ###   #
#  , # ##    # # # # # # # # ## # ## #####       ## ## ## #        # # #       ##### ## ##
###,##### # ## # #     #######  # #####  ## # ##     #  #   ##### ## # # ### #  # #  ##  #
#  ,# # ### ##     ###### # ## ##  ## ##  # #### ## ## ## ### ###### # # ### ##     ##  ##
###,# #  #     ###          #  ## ##  ## ##  # #######      # # ##   # #   #  ## ## ## ###
# #,,,## ## #### # ## # ##### ##  #  ##  ## ## ## ###  # # ##    ###     #############   #
# ###,## ## #    #  # #   ##  ## ## ### ### #   # # # ######## ### # ###     ## #  ##  # #
# ###,##      # ####### ##### ##      # # # # ### #    ######   ## #   ########   ##  ## #
# # #,## ########     # ##    ## ### ## #       #   #### # #  #      #### # # ## ### ##  #
#    ,##    ## ## # ######## ##    ####   ####### ### #  # # ## ## #   #  # #  #      ####
#####, ### ##   # ###  # # # ### #####  #  ###          ## # ####### # # ## # ## ####   ##
#  ##,###   ## ##  ## ## # #           ###     ##### # ##     ## ####### ##         # #  #
## #,,# ###  #  # ###  # # # # ## ### ##   ###    ## #    # #  #    # #     ############ #
#   ,## # # ## ## # # ##   # ##########  #  ## # ###### ### ##   ##     ###    #### ###  #
####,##        #    # ### ##    ##    #### ##  ###  # #   ###  #  ## ##   # ##        ####
### ,,#### ###   #### # # ## ##### #### ######   ## # ###  ## #####   ## ##  # # ### #####
# ###, ##   ###### ##      # #  #  # #   ## #  #        ##  #     # #### ## ## #   #     #
#  ##,##  #  ## ## ## # ####   ## ##   #    # ## ########## ### ###### ###   #### ## # ###
## ##,## ###       ## ####   #  #    ###### # #           #####         ## #### #  #######
#  #,,## # ## ######   # # ####   ##      # # # # ## # #####  # # # ## ##       ##  # ## #
## #,##     ### # ## ### #    ######### ### # # # ## #       ## # ####  ##### #### ## ## #
## #,   ## ####   ##  ## # ######## # ######### #  ### ## # ######## #### ###### #       #
#,,,,# ###### # #####        ##           ## ########  ####    # ##  ## #   ##   # #### ##
#,####    #   #    ## ######### ###########  # # ## ##   ## #### #  ###   #    # #  ##   #
#,,# ###### ### ##### ####### #         ### ## #  # ## ####### # # ## # ###########  # # #
##,#     ## ### ## #            ## ## #   # ## # ## ###### #   #        ## ###    ## # # #
# ,  #####,,,,,,,# # ####### # ##########   ## # ##    # # # ### # ####        ###########
##,#######,## ##,,,,,##    ######## ## ####         #### # # # # ### ### #######  # ### ##
# ,,,,,,,,, #  ## ##,,, ##      ##      #### # #### # #           ## # #       ##    #   #
## ## # ### # ##  ####,#### #####  ####    ###   ####   #### ####      ##### #    ##   ###
#   # #######  ##   ##,######## ## # ## ##   ##### #  #   ##    # # ## ### ########  #####
# # #       # ### #  #,,## #,,,,,#   ###########   # ### #### #####  #      # ### #####  #
### ## ## ### ##  # ###,,,,,,###,,,### # ##      #    #####      ## ## ## ### # #  ## # ##
#   ##  #   ##### #   ## # #######,,,,,,,,## ## #####  ## ### ##### ## ## ### # # ##  #  #
### #  ## ###  #  # #  # #     ##### # ##,    #     ##      # ### ######          #  ## ##
#   # ##   ###   #### ## ## ##     ######,############# # ###          ## ## ## ### ### ##
##### ## #  ## #    # ##  ##### ##### ## ,,,,  #     ## ###### # ### # ## ##  #  #   #   #
#  ##  # ##  # # ########    ##        ## ##,### ########## ####   ######  ## ##   #   # #
##    ##  # ## #        ## #  # # ## #  # ##,,## # # # ##      # #      ## ## ## # # #####
#  # ##  ##  # # ## # ###  # ## #  ### ##  ##,,,,#   #    ########### #  ###   # ###     #
## ######## ## # ## #  ##### ## # #### ## ##  ##,, ### ######   #  #####   ### #  ## # # #
#     ##  ########  ##     #### #    #  #  ##  ##,## #        # # ## # ########## ## # ###
# # #  ##  #   ##  #### ##  ##  ## ###### ####  #,,,,,,##########       # ## ## #  # #   #
# # ##  ##   ########    ##  ####      ####### #######,,## #   ## ### # #  # ## # #### # #
# #####    #    # ##  # ####   ### # #     ##        ##,#    ###   ###### ## #  #   ######
#     ## # # ##    # ##   ## #  ## # # ## #### # # ### ,, ####   ###   ##      ## #      #
## # ##  # # ## ######  # #  # ##### #  #  ##  # #  ## #,##### ##### ###  # # ##### ## ###
#  ##### # ####   # ######## #   ##  # ## ###### ##  ###,,,,             ## #     # #### #
##     # #####  #    #     ######### #  #     ## ## ##   ##,## # ## # ####  ## # ##   #  #
### # ##   # ## # # ## ######    ##  ##### # ### #  ## #  #,,# #  # #   ### #  ######   ##
#   # ## #    ### #           ##  ##    ## #   #### #  ## ##,###### # #  #####      ## ###
### ###  ## ####  # ## # # ##### #### ###  # #### # # ##  ##,,    ### ##   ##  ### ##    #
#   ##  ##     # ####### #  ## #  ##  #### #      # #  ######,#########  #  # ######## # #
# # ## #### ####       ### ##  ##  ## # #  ##### ## ##   ## #,        # ########     #####
# # ## ####    # ## ##  ##    ##  ###   ##    ######### ### #,#########   ## ##  # # ## ##
# ###   ##  ## #  #  # #### #  ##   # #### # ## ## # ## ##   ,       ### ##     ######   #
###### ####  ### ### ### #  # #######    # #         ## ## ##,# # #### #### ####### #  # #
#       ##  ##    #####  # ##       ###### ## ## # #### #  ##,#######,,,##    ## #    ####
#### # ##  ### ##     ##    ## # ##  # # #########    # ## # ,,,,,,,,,#, # ####    #### ##
#    ###  ##    # # # ### ###  #####      # ### #  # ##### # # # ######,##  ### ######   #
#### ####  # # ## # #  ##   # ##     ####   #   # ##   # ##### #     ##,,,,## #  ##    # #
##     ## ## ###  # # ##  ###  # # #   ## #   ##########  # ## ## # ### ##,,    ##  ######
#  # #  # ##  ##### #  ##   # #### # #  # ## ## ###      ##     ###   # ###,# #  ##    ###
## # # ######  ###  # ##  ### # #### #### ##        ## #  ### #   ## ## #  ,####    ##   #
## ###   #  ##   #### ## ####    ##     #### # # # ###### ##  ########  ###,,,## #########
#    # #   ##  #   ## #     ## #  ## ## ## # # # #  # #    ##        ####   #, #     ### #
## ### ## #### ## ##  # # #  # # ###  #    ### # #### # # ### # ## #    # ###,## # #     #
#   ##  #   ## ##  ## # # ## #####   #### #### #  # # ######  #  ##### ##  ##,,### # # ###
## ### ## #  ###  ##  #####      ### #  #    ####      # # ## ##     # ## ####,  ### #   #
#  ##   # # #####  ##   ### ## # ##    ## ##  # # # ##     ## ## # # ###    ##,#  ## # # #
##  ## ####  # ###  ###   #  # # #  # ##   ##   ###  # # #  ########   # # ## ,####  #####
#  ##     ##   # ##  ## ######## ## ###  #### ###### # ####   # # ## ##### ###,,# ########
##  # ## ##  # #    ##         # #   ######        ###   ## #      #    #### ##,,,,,,,,# #
#  ## ## ##### ### ##  #### ## # # #    ##  ## ## ##   ###### ## ######## ##    # ## #,  #
## ## ##    ###### ###    ###### # # ##  ##  #  ######    ##  ## ## #     ## # ##  # #,###
## ## ## ####        ## #      # # # ####### ##  # #### ##### ##      ## ##### ## ## #,  #
#   ###     # # # ## ###### # ## ###   ## ##  ##     ##     #  ## #####    ##   # ## #,###
## ##   ## ## ### ##      # #  # #####    #####  ## ### # # # ##      # # #### ##  # #,  #
###### ###### #   ### # # # # ##    #####     ##  # # ### # ###### ######## #  ## ## #,###
#      #    #####   ### # # #  # # ## #### ####  ## #   # #  ##      # # ## ######## #,, #
#### #   # ####   #  ## # # # ## #       #   ## ##    ###### ## ## #          ## # ####,##
#    # ### #    # # ####### # ## # ## # ### ##   ## #    ##  ## ## ##### # ##        ##,,#
# # ##   # ### ## #    #  # # ## #  # #   # #### ## ## #  ##  # ##     ####### # #######,#
# #  ## ## ##   # # ##   ## #  # # ## # # #  ##  ##  # # ##  ##  ## ##     ##  #       #,#
########################################################################################,#
