# ######.######################################################################################################
#       ......... ## # ...# # # #  # # ##  ##     ## # # ## # ## # # ##      # #  ##    # #  ####    ##    # ##
## #############.### ##.#.........##    ##  ## ## #      #       #   ## ## #   ##  ####   ##  ##  ##    ####  #
#  ##      # #  .# #....## ######. #### ## #####    ## # ####### ### #########    ## #  ##### ######### # ## ##
## ##### #   ###.....##### ######.##  # ##  # ### ######     ##   #   ## #  ##### ##   ## ##  # ## ##   # ##  #
#  #     ### #### ######   #     .### #  ## # # # #####  # #    # ###  # ##  ###   ### ##  ## # #   ## ##  # ##
# ## ## ###       #      # ## ###.# # # ##  # # ### ##  ######### # ## #  ## #   ###    # ### # ## ##  ### # ##
# ##### #   ## # ### ### ####### ...# #  ##     ##  ###  ###   #    ## # ##  ###     ##   # #   ## ###  ## #  #
### # #####  # # # #######  ##   ##.....###### ##  ## #### ### #### ## # ###  ### # #### ## ### ## # ##      ##
#   #  #    ###### ##  ####    # ######. # ###  ## ## ## # # # #         # ##  ####### #  # # # ## # #### #####
### ## #########      ## ######### ####.##   ##    ##  #       ###### ##   ### # # # # ##   # # ## # #     ## #
##   #   ### # ### ##     #  ###::::::::,### ### #  ## ####### ##   ###  #     # # # #  ###     ##   #### ### #
#  # ### # # # ##   ##### ##   *:##### #,# #  #### ##  ##         ###### #####       ##   #### ##  #  #       #
####         #  ###### #     ### #     #,# # ## #   ##  ### ## ##  ##  ############# ## # # #  ###### ### #####
###  #######   ## ##     # # #   ## # ##,,,,,## ### ###  ######### ## ##     #  ###  #### # ##  # # # #       #
# ###### #### ##  ############ ########  ###,,# ###  ## ## #     # ## ###### ##   ##  ##  #    ##       #######
#  ##          ## # # # #  ####### # ### ####,# # ##    #  # # #    #  ##  # ## #  ##  ## ### ######### # #####
## ##### #####      # #   ## ##  # # # ###   ,,,#  ####   ######### ## ###   ##### ## ##      # # #  ##       #
#  # #   ########## # ### ##  ## #   # ########,,,####  ##### ## #   # # ###   # # #,,,#### # # # # ##  # # ###
##     # #    ### # # ##   ## ## ### # #  #     #, # ## # ##       #   # #####    ,,,#,,,####       ### #######
##### #######   #     ### ##  #        ## # #####,## #  #  ########## ## #,,,#####,#####,# ########      ##   #
# ### #       #   # #      ## ### # ## ## ###    ,#  ## # ## # #####,,,,,,,#,,,,,,,#    ,,,,,,,,,### ######## #
#   ############# ##### ##    #######     ##  ###,##,,,,,,,,,,,,,,,,,# # # ## # ###### ## ######,,,#   #  # # #
### #### ## ## ####     ### #   ## #  ###    ### ,,,,# ##### ## # ## ##### ## ###   #######      #,,,### ## # #
#   # #          #### ###   ###      ##   # ##   # # ###      #####   ##    ####### # ## #### ######,,,, #    #
### # ######### ## ####   # ###### # ## #####  # # ###### ###### ### #### # ##              # ### #####,## ####
#      ## # ##       ###### #      # #  #############     ##            #####  # # # # # ## ###    ### ,      #
###### #     ###### ## #    ##### ## #### # ### ##    ### ## ## ## #### ## ### # # ### ###   ##### # ##,### ###
## ### ## ##   # ## ## ## ###     #  ####        #### #   ####  #  ## ###   ###### #   #### ## ##  #  #,# ### #
#    # #######      ##  ###### ## ## #    ###### # ######    ## ####   #  ### ##   ### #        ## ## #,#  #  #
####   # # #### ###  ## ##  ######## ## # #  ##  #     #  ####### #### ## # # ###### ##########     # #,# ## ##
######          ####     # ## # ## ######### ### ## ##   ##  # #               ## #   # ###   ### #    ,,,    #
#   ### # # ## ## ### ##   ## # #  ##         #   ##### ####     ### # # # # #    ### #     #  ##########,#####
###     # ###  #  #   #  # ## # ##  ####### #   #  #    ## ### ###   # ######### ###  ########           ,  # #
###### ## ##  ###   ###### #  #  ##  #    ### # ##   ####  ##  #   # # ###### ##     ## #      ## #######,### #
#   ## ######## ### ### ## ##   #### ## #  #  # ########## ## #### ##### # #   ##### ## ############ #,,,,    #
## ##  # #  ###     #         ####    #### ## # #        # ##### ###       ### ## #   #  ## # # ##,,,,,# ## # #
#   #### ##   ############### ##   ##  ##   ########## #   # # #  ## # # #     #  ### ## #  #     ,# # # #### #
## ## #   ###                  ####### ### ### #   ### ### # # ##  ########### # ## # ## ## #### #,# # #   ## #
## ## # #   ################## # ## ## # # ##  ## ## #####      ##   ## ##       #               #,# # ## ##  #
#   # ##### ##  ##       #     # #       # ###    #  ###   ### #### ##   #######   ## # # ###### #,######  ## #
### # ##     ## #  #####   # #     # # #   # #### ## #   # #   ## #  ### # # #   # #  # ####     #,##     ##  #
### #  #### ##  ######   # #### ## ####### # #### ## #########    # ##         # #### #### ## # ##, # # # ### #
#   ## # ## ###  ### ## #####   ## ###            ## # #  ##   ## # ##### ### ## ## ###       ###,,## # #  ## #
# #          #  ## #    ##    # #### ############ ## # ## #  ###     ##   ### ## #   ##### ## ## ,##### ## #  #
####### ## #   ##  # ############ #           #             ####### ##  # #    # # #  ##    #####, ##   ## ## #
###     ######  ## ### # ##    ## ## ## #####   # # # #### ##   #      #### # ## ####    # #### #,#### ##  #  #
# ## # ## ##   ##   ##    #### ##    ####     # # ### ####### #   # ## ##   #  ####### # #### #  ,,##   ## ## #
#    # #     #  ## ##### ## #     ##  ####### ### #   #   #   ## ##  # ### ## #### # # #####    ##,,## #####  #
########## # ##    # # #  # #### ###### #       ##### ###   ###   ## #  ########       ###   ##  ##,,#    ### #
# ### # #  # ##### # # ##      #######    # # #### ####   #  ### ##  #### #    ### # # #   # #  ####,### ## # #
#       #### #          #### #### ##   ######### # # ### ## ##    ######    ##     ####### # ##  ## , ## ##   #
####### # ######## ## #  ##    #   #####              ####  #  # ###     # ### ## ### # #  # #  ####,####### ##
### #     # # #    #  ##    ##   #       ## ## # # ##  ##  ### ### ##########   ###       ## ## ## #,#   ##   #
#   ## ##   #   # ### ### # ## # ### ### #   ### ##### ##### # ### ###### # ############ #####  ##  ,, #### # #
# #    #  #   # # ##    ###  ### #   #   # ####  ### #         #        #                ###### ### #,### # # #
###### ## ### ### ### ###   ##   # # ## ####    ## # ## # ## # ## # # #   ## ## # #### #  ##      ###,    ### #
##     #  ##  #    ####   # #### # # #   ###### #       #  # #  # ### ## ### ###### #### ##  ## # # ,,## ######
#  # # ######### #  ##  # #  ######### ### ## ####### ### ################ ### #         ### ## # ##,###      #
## # # #         ## ### # ## # ## # ####               ## ##  ## ##  ##     #    ##### #  ## ## ####,  ## # # #
######## # # ### ####   #### #           ### # ### # # ## ###       #######   ######   # ###  # # ,,,# ## ### #
### # #### ####### ########  ## ##########   ###   ### #### ### # #  # #    # #      # # ##  #####,# ####   # #
##         ##   #     ### ########     ##### ##### ##  #     ####### # #### #### # # ###  ##  ## #,###    ### #
#  ## ### ##  #   # #     ##  ## #####   # #   ### ### ##### # # #          ## ### #  ## ##  ##   ,  ## #  ####
# ########### ## ########  ## #  ### ###     # #    ## ##      # #### # # # ## ##  # ##   ##  ####,#######    #
### #         #   ###   # ### ## #       # # # ## #  ###### ##        # # ###     ## ## #### ##   ,,   ##  # ##
###   ########## ## ###   ##       #### ## # # #  ##  ##    ## ## # ########### # #  #   ##  #### #,# ##  #####
# ## ##          #      #  ###### ###   ## # # ## #  ##  ####  ## #### # ## #   #### # #  ##  ##  #,#####     #
#  #######################        #   # #  # # ###########    ##  #           # ## # # # ##  #### #,,,##  # # #
##  ## # # ## ##     ###   # ## # ### # # ######        ################# # # # #    # #  ##  # ### #, ## # # #
###              ###     # ###  # #   # # ##     ##### ##  #### ###       ### ##### ## # ### ## #   #,####### #
# ######### # ##  ### ## ##### ##### ## ###### # #      ##          # # # ##  ##    ###### # ## ### #,,,   ## #
# ###       # #  ##   ####      ##   ## ## #   ###### #  ### # ## ### ### #########    ##    ##     # #,## ## #
#     # # # ####  ## ##    ### ##  # ## #    # ##  #####     #######  ##  #    #    ###### # ## # ### #, ######
### # # ###   ### ###### # ##  ##### ## ## # #  ## # #   # ####      ##  ## ##   ##   ##   # ## # #   #,### ###
#   ###  ## #  #### #    #####  ##   ## #  ######      # ###    ####  ##  # #  # #  #  ### #### ### # #,      #
## ##   ##  # ##      ##  ## ###### ######### # ########  ##### #    ##  ## ####### # ##      # ##### #,#######
#  ## # ## ###### # # #####   #     ##          ##       ##     ### #### ## #   #   # ## # ## ### ### #,  #   #
## ## # #### ## ##### #     #   ## ##  #### # #  ####### ## # # #   ## # ## # #   ### ## # ## ###     #,#   ###
## ## # #          ########### ### ### ##   # ##         ###### ## ##     ##### #  ## ## #  # # #### ##,## ## #
#  #  # ## # # # #   # # # # #   # # ###### #  ## ## ## ##   ## #   ### #  # #### ##   # ## ###      ##, #    #
# ##### #  # ####### # #       #####        #######  #######    ### #   ####   ##  ### #  ####  ## #  #,#### ##
####    # ##### ##     ### # #   ##  #### # #  ##### #       ## #   # #   ## #    ##   # ###   ##### ##,# #####
#    # ##  ###   #####     #### ##  ##    # ##  #    #### ## #  ### # # #  ##### ##  # # ##  # ## #### ,,,, # #
### ##  ## #   #   ##### # #     ## ##### #####   ## #     ### ###  # # # ##      ## # ###  ## ##      # #,## #
#    ##  # ## ## #       # #### ##  # ##  ###### ####### # ### ##  ## # # #  ## # ## #   ## #  ## ## # # #,#  #
## # ### ############## ######   ####    ## ##    ##     # #   #  ##  ### ##  ###  ### ###  # ### ## # # #,, ##
#  # #   ##               ##   #  ##  # ##     # ##  # # # # # # #### #    ## #   ##     ## #   # ## # # ##,###
###########################################################################################################,###
